,VACCINATION_DATE,FirstDailyDose,FirstDoseCumulative,SecondDailyDose,SecondDoseCumulative,AdditionalDailyDose,AdditionalDoseCumulative,SingleDailyDose,SingleDoseCumulative,AtleastOneVaccine,AtleastOneVaccineCumulative,CompletedVax,CompletedVaxCumulative,FirstSecondSingleVaccinations,FirstSecondSingleVaccinationsCumulative
0,2020-12-14 15:00:00,21,1641,,559,,2,,,21,1641,0,559,21,2138
1,2020-12-15 15:00:00,69,1710,3.0,562,,2,,,69,1710,3,562,72,2210
2,2020-12-16 15:00:00,695,2405,6.0,568,,2,,,695,2405,6,568,701,2911
3,2020-12-17 15:00:00,1284,3689,11.0,579,,2,,,1284,3689,11,579,1295,4206
4,2020-12-18 15:00:00,3141,6830,13.0,592,,2,,,3141,6830,13,592,3154,7360
5,2020-12-19 15:00:00,1004,7834,9.0,601,,2,,,1004,7834,9,601,1013,8373
6,2020-12-20 15:00:00,397,8231,6.0,607,,2,,,397,8231,6,607,403,8776
7,2020-12-21 15:00:00,3961,12192,28.0,635,,2,,,3961,12192,28,635,3989,12765
8,2020-12-22 15:00:00,6381,18573,32.0,667,,2,,,6381,18573,32,667,6413,19178
9,2020-12-23 15:00:00,5848,24421,44.0,711,,2,,,5848,24421,44,711,5892,25070
10,2020-12-24 15:00:00,2776,27197,17.0,728,,2,,,2776,27197,17,728,2793,27863
11,2020-12-25 15:00:00,1036,28233,4.0,732,,2,,,1036,28233,4,732,1040,28903
12,2020-12-26 15:00:00,1917,30150,10.0,742,,2,,,1917,30150,10,742,1927,30830
13,2020-12-27 15:00:00,1827,31977,13.0,755,,2,,,1827,31977,13,755,1840,32670
14,2020-12-28 15:00:00,9207,41184,61.0,816,,2,,,9207,41184,61,816,9268,41938
15,2020-12-29 15:00:00,11234,52418,59.0,875,,2,,,11234,52418,59,875,11293,53231
16,2020-12-30 15:00:00,12772,65190,104.0,979,1.0,3,,,12772,65190,104,979,12877,66108
17,2020-12-31 15:00:00,7682,72872,56.0,1035,,3,,,7682,72872,56,1035,7738,73846
18,2021-01-01 15:00:00,3669,76541,163.0,1198,8.0,11,,,3669,76541,163,1198,3840,77686
19,2021-01-02 15:00:00,3325,79866,38.0,1236,,11,,,3325,79866,38,1236,3363,81049
20,2021-01-03 15:00:00,3462,83328,86.0,1322,,11,,,3462,83328,86,1322,3548,84597
21,2021-01-04 15:00:00,13491,96819,368.0,1690,2.0,13,,,13491,96819,368,1690,13861,98458
22,2021-01-05 15:00:00,12645,109464,595.0,2285,1.0,14,,,12645,109464,595,2285,13241,111699
23,2021-01-06 15:00:00,15426,124890,977.0,3262,1.0,15,,,15426,124890,977,3262,16404,128103
24,2021-01-07 15:00:00,15245,140135,1899.0,5161,,15,,,15245,140135,1899,5161,17144,145247
25,2021-01-08 15:00:00,24212,164347,2935.0,8096,,15,,,24212,164347,2935,8096,27147,172394
26,2021-01-09 15:00:00,5437,169784,1034.0,9130,1.0,16,,,5437,169784,1034,9130,6472,178866
27,2021-01-10 15:00:00,3056,172840,402.0,9532,,16,,,3056,172840,402,9532,3458,182324
28,2021-01-11 15:00:00,13873,186713,3529.0,13061,2.0,18,,,13873,186713,3529,13061,17404,199728
29,2021-01-12 15:00:00,17646,204359,5648.0,18709,,18,,,17646,204359,5648,18709,23294,223022
30,2021-01-13 15:00:00,18868,223227,3985.0,22694,,18,,,18868,223227,3985,22694,22853,245875
31,2021-01-14 15:00:00,18197,241424,2007.0,24701,1.0,19,,,18197,241424,2007,24701,20205,266080
32,2021-01-15 15:00:00,19840,261264,2083.0,26784,3.0,22,,,19840,261264,2083,26784,21926,288006
33,2021-01-16 15:00:00,6115,267379,1660.0,28444,,22,,,6115,267379,1660,28444,7775,295781
34,2021-01-17 15:00:00,2183,269562,1491.0,29935,1.0,23,,,2183,269562,1491,29935,3675,299456
35,2021-01-18 15:00:00,7258,276820,3333.0,33268,3.0,26,,,7258,276820,3333,33268,10594,310050
36,2021-01-19 15:00:00,17203,294023,5508.0,38776,1.0,27,,,17203,294023,5508,38776,22712,332762
37,2021-01-20 15:00:00,21189,315212,5412.0,44188,2.0,29,,,21189,315212,5412,44188,26603,359365
38,2021-01-21 15:00:00,24146,339358,3934.0,48122,2.0,31,,,24146,339358,3934,48122,28082,387447
39,2021-01-22 15:00:00,28867,368225,3833.0,51955,,31,,,28867,368225,3833,51955,32700,420147
40,2021-01-23 15:00:00,10293,378518,2021.0,53976,1.0,32,,,10293,378518,2021,53976,12315,432462
41,2021-01-24 15:00:00,3423,381941,1765.0,55741,2.0,34,,,3423,381941,1765,55741,5190,437652
42,2021-01-25 15:00:00,16478,398419,8807.0,64548,2.0,36,,,16478,398419,8807,64548,25287,462939
43,2021-01-26 15:00:00,17762,416181,9171.0,73719,2.0,38,,,17762,416181,9171,73719,26935,489874
44,2021-01-27 15:00:00,24628,440809,12817.0,86536,2.0,40,,,24628,440809,12817,86536,37447,527321
45,2021-01-28 15:00:00,22978,463787,9479.0,96015,3.0,43,,,22978,463787,9479,96015,32460,559781
46,2021-01-29 15:00:00,25111,488898,8147.0,104162,9.0,52,,,25111,488898,8147,104162,33267,593048
47,2021-01-30 15:00:00,17996,506894,2757.0,106919,5.0,57,,,17996,506894,2757,106919,20758,613806
48,2021-01-31 15:00:00,3817,510711,1475.0,108394,5.0,62,,,3817,510711,1475,108394,5297,619103
49,2021-02-01 15:00:00,8391,519102,5607.0,114001,59.0,121,,,8391,519102,5607,114001,14057,633160
50,2021-02-02 15:00:00,12684,531786,14033.0,128034,6.0,127,,,12684,531786,14033,128034,26723,659883
51,2021-02-03 15:00:00,18470,550256,18360.0,146394,2.0,129,,,18470,550256,18360,146394,36832,696715
52,2021-02-04 15:00:00,22406,572662,16091.0,162485,3.0,132,,,22406,572662,16091,162485,38500,735215
53,2021-02-05 15:00:00,20643,593305,17791.0,180276,6.0,138,,,20643,593305,17791,180276,38440,773655
54,2021-02-06 15:00:00,11625,604930,14830.0,195106,7.0,145,,,11625,604930,14830,195106,26462,800117
55,2021-02-07 15:00:00,6045,610975,2009.0,197115,2.0,147,,,6045,610975,2009,197115,8056,808173
56,2021-02-08 15:00:00,13152,624127,13123.0,210238,12.0,159,,,13152,624127,13123,210238,26287,834460
57,2021-02-09 15:00:00,16945,641072,14114.0,224352,,159,,,16945,641072,14114,224352,31059,865519
58,2021-02-10 15:00:00,19534,660606,21582.0,245934,5.0,164,,,19534,660606,21582,245934,41121,906640
59,2021-02-11 15:00:00,23078,683684,17689.0,263623,8.0,172,,,23078,683684,17689,263623,40775,947415
60,2021-02-12 15:00:00,20657,704341,19938.0,283561,10.0,182,,,20657,704341,19938,283561,40605,988020
61,2021-02-13 15:00:00,11589,715930,6514.0,290075,1.0,183,,,11589,715930,6514,290075,18104,1006124
62,2021-02-14 15:00:00,7219,723149,2208.0,292283,3.0,186,,,7219,723149,2208,292283,9430,1015554
63,2021-02-15 15:00:00,11942,735091,13482.0,305765,16.0,202,,,11942,735091,13482,305765,25440,1040994
64,2021-02-16 15:00:00,16920,752011,21219.0,326984,7.0,209,,,16920,752011,21219,326984,38146,1079140
65,2021-02-17 15:00:00,20827,772838,26614.0,353598,8.0,217,,,20827,772838,26614,353598,47449,1126589
66,2021-02-18 15:00:00,3267,776105,4668.0,358266,5.0,222,,,3267,776105,4668,358266,7940,1134529
67,2021-02-19 15:00:00,10404,786509,20148.0,378414,8.0,230,,,10404,786509,20148,378414,30560,1165089
68,2021-02-20 15:00:00,10405,796914,20506.0,398920,4.0,234,,,10405,796914,20506,398920,30915,1196004
69,2021-02-21 15:00:00,6375,803289,7849.0,406769,8.0,242,,,6375,803289,7849,406769,14232,1210236
70,2021-02-22 15:00:00,8122,811411,15650.0,422419,14.0,256,,,8122,811411,15650,422419,23786,1234022
71,2021-02-23 15:00:00,15633,827044,16209.0,438628,6.0,262,,,15633,827044,16209,438628,31848,1265870
72,2021-02-24 15:00:00,18124,845168,25096.0,463724,8.0,270,,,18124,845168,25096,463724,43228,1309098
73,2021-02-25 15:00:00,20587,865755,26932.0,490656,8.0,278,,,20587,865755,26932,490656,47527,1356625
74,2021-02-26 15:00:00,26829,892584,26551.0,517207,14.0,292,,,26829,892584,26551,517207,53394,1410019
75,2021-02-27 15:00:00,16182,908766,11422.0,528629,8.0,300,,,16182,908766,11422,528629,27612,1437631
76,2021-02-28 15:00:00,15594,924360,4989.0,533618,22.0,322,,,15594,924360,4989,533618,20605,1458236
77,2021-03-01 15:00:00,27766,952126,12898.0,546516,64.0,386,,,27766,952126,12898,546516,40728,1498964
78,2021-03-02 15:00:00,24267,976393,13468.0,559984,9.0,395,39.0,39.0,24306,976432,13507,560023,37783,1536747
79,2021-03-03 15:00:00,30494,1006887,18629.0,578613,11.0,406,201.0,240.0,30695,1007127,18830,578853,49335,1586082
80,2021-03-04 15:00:00,31241,1038128,18491.0,597104,5.0,411,4073.0,4313.0,35314,1042441,22564,601417,53810,1639892
81,2021-03-05 15:00:00,30384,1068512,19996.0,617100,7.0,418,4950.0,9263.0,35334,1077775,24946,626363,55337,1695229
82,2021-03-06 15:00:00,19191,1087703,9713.0,626813,2.0,420,6118.0,15381.0,25309,1103084,15831,642194,35024,1730253
83,2021-03-07 15:00:00,12240,1099943,4999.0,631812,1.0,421,6668.0,22049.0,18908,1121992,11667,653861,23908,1754161
84,2021-03-08 15:00:00,26080,1126023,8990.0,640802,12.0,433,8370.0,30419.0,34450,1156442,17360,671221,43452,1797613
85,2021-03-09 15:00:00,26298,1152321,15663.0,656465,2.0,435,8434.0,38853.0,34732,1191174,24097,695318,50397,1848010
86,2021-03-10 15:00:00,30103,1182424,16264.0,672729,12.0,447,7983.0,46836.0,38086,1229260,24247,719565,54362,1902372
87,2021-03-11 15:00:00,36249,1218673,16558.0,689287,6.0,453,4026.0,50862.0,40275,1269535,20584,740149,56839,1959211
88,2021-03-12 15:00:00,37176,1255849,18380.0,707667,8.0,461,2979.0,53841.0,40155,1309690,21359,761508,58543,2017754
89,2021-03-13 15:00:00,22875,1278724,10481.0,718148,1.0,462,1670.0,55511.0,24545,1334235,12151,773659,35027,2052781
90,2021-03-14 15:00:00,17989,1296713,6879.0,725027,4.0,466,1032.0,56543.0,19021,1353256,7911,781570,25904,2078685
91,2021-03-15 15:00:00,30237,1326950,11535.0,736562,14.0,480,620.0,57163.0,30857,1384113,12155,793725,42406,2121091
92,2021-03-16 15:00:00,33758,1360708,13709.0,750271,14.0,494,799.0,57962.0,34557,1418670,14508,808233,48280,2169371
93,2021-03-17 15:00:00,37986,1398694,17284.0,767555,10.0,504,1200.0,59162.0,39186,1457856,18484,826717,56480,2225851
94,2021-03-18 15:00:00,41940,1440634,12892.0,780447,8.0,512,1365.0,60527.0,43305,1501161,14257,840974,56205,2282056
95,2021-03-19 15:00:00,38809,1479443,15605.0,796052,10.0,522,1063.0,61590.0,39872,1541033,16668,857642,55487,2337543
96,2021-03-20 15:00:00,25084,1504527,10378.0,806430,7.0,529,711.0,62301.0,25795,1566828,11089,868731,36180,2373723
97,2021-03-21 15:00:00,19378,1523905,7960.0,814390,10.0,539,347.0,62648.0,19725,1586553,8307,877038,27695,2401418
98,2021-03-22 15:00:00,32887,1556792,11623.0,826013,23.0,562,836.0,63484.0,33723,1620276,12459,889497,45369,2446787
99,2021-03-23 15:00:00,38742,1595534,18024.0,844037,5.0,567,1568.0,65052.0,40310,1660586,19592,909089,58339,2505126
100,2021-03-24 15:00:00,41491,1637025,21448.0,865485,13.0,580,1399.0,66451.0,42890,1703476,22847,931936,64351,2569477
101,2021-03-25 15:00:00,43283,1680308,21972.0,887457,6.0,586,2473.0,68924.0,45756,1749232,24445,956381,67734,2637211
102,2021-03-26 15:00:00,36822,1717130,26890.0,914347,7.0,593,2513.0,71437.0,39335,1788567,29403,985784,66232,2703443
103,2021-03-27 15:00:00,26822,1743952,17528.0,931875,8.0,601,2515.0,73952.0,29337,1817904,20043,1005827,46873,2750316
104,2021-03-28 15:00:00,17225,1761177,12783.0,944658,10.0,611,1618.0,75570.0,18843,1836747,14401,1020228,31636,2781952
105,2021-03-29 15:00:00,30043,1791220,26632.0,971290,16.0,627,1155.0,76725.0,31198,1867945,27787,1048015,57846,2839798
106,2021-03-30 15:00:00,40534,1831754,29316.0,1000606,6.0,633,1887.0,78612.0,42421,1910366,31203,1079218,71743,2911541
107,2021-03-31 15:00:00,41471,1873225,35085.0,1035691,18.0,651,5779.0,84391.0,47250,1957616,40864,1120082,82353,2993894
108,2021-04-01 15:00:00,43229,1916454,41625.0,1077316,81.0,732,5943.0,90334.0,49172,2006788,47568,1167650,90878,3084772
109,2021-04-02 15:00:00,35599,1952053,33045.0,1110361,14.0,746,6271.0,96605.0,41870,2048658,39316,1206966,74929,3159701
110,2021-04-03 15:00:00,21586,1973639,19504.0,1129865,4.0,750,4446.0,101051.0,26032,2074690,23950,1230916,45540,3205241
111,2021-04-04 15:00:00,8533,1982172,10315.0,1140180,3.0,753,991.0,102042.0,9524,2084214,11306,1242222,19842,3225083
112,2021-04-05 15:00:00,28237,2010409,29195.0,1169375,22.0,775,6753.0,108795.0,34990,2119204,35948,1278170,64207,3289290
113,2021-04-06 15:00:00,40124,2050533,30744.0,1200119,15.0,790,10597.0,119392.0,50721,2169925,41341,1319511,81480,3370770
114,2021-04-07 15:00:00,36549,2087082,34624.0,1234743,8.0,798,13147.0,132539.0,49696,2219621,47771,1367282,84328,3455098
115,2021-04-08 15:00:00,42669,2129751,36499.0,1271242,10.0,808,14021.0,146560.0,56690,2276311,50520,1417802,93199,3548297
116,2021-04-09 15:00:00,34513,2164264,36688.0,1307930,9.0,817,14649.0,161209.0,49162,2325473,51337,1469139,85859,3634156
117,2021-04-10 15:00:00,23891,2188155,23505.0,1331435,4.0,821,7797.0,169006.0,31688,2357161,31302,1500441,55197,3689353
118,2021-04-11 15:00:00,17706,2205861,13428.0,1344863,2.0,823,10246.0,179252.0,27952,2385113,23674,1524115,41382,3730735
119,2021-04-12 15:00:00,24879,2230740,33575.0,1378438,13.0,836,11119.0,190371.0,35998,2421111,44694,1568809,69586,3800321
120,2021-04-13 15:00:00,126529,2357269,91703.0,1470141,10.0,846,3308.0,193679.0,129837,2550948,95011,1663820,221550,4021871
121,2021-04-14 15:00:00,41341,2398610,38306.0,1508447,14.0,860,208.0,193887.0,41549,2592497,38514,1702334,79869,4101740
122,2021-04-15 15:00:00,41867,2440477,40035.0,1548482,22.0,882,169.0,194056.0,42036,2634533,40204,1742538,82093,4183833
123,2021-04-16 15:00:00,37598,2478075,39361.0,1587843,11.0,893,27.0,194083.0,37625,2672158,39388,1781926,76997,4260830
124,2021-04-17 15:00:00,33196,2511271,22428.0,1610271,13.0,906,13.0,194096.0,33209,2705367,22441,1804367,55650,4316480
125,2021-04-18 15:00:00,20180,2531451,16373.0,1626644,4.0,910,5.0,194101.0,20185,2725552,16378,1820745,36562,4353042
126,2021-04-19 15:00:00,30136,2561587,36906.0,1663550,16.0,926,62.0,194163.0,30198,2755750,36968,1857713,67120,4420162
127,2021-04-20 15:00:00,33217,2594804,44974.0,1708524,12.0,938,60.0,194223.0,33277,2789027,45034,1902747,78263,4498425
128,2021-04-21 15:00:00,40347,2635151,47552.0,1756076,14.0,952,24.0,194247.0,40371,2829398,47576,1950323,87937,4586362
129,2021-04-22 15:00:00,36237,2671388,43264.0,1799340,21.0,973,17.0,194264.0,36254,2865652,43281,1993604,79539,4665901
130,2021-04-23 15:00:00,33539,2704927,40755.0,1840095,9.0,982,14.0,194278.0,33553,2899205,40769,2034373,74317,4740218
131,2021-04-24 15:00:00,26701,2731628,28342.0,1868437,6.0,988,80.0,194358.0,26781,2925986,28422,2062795,55129,4795347
132,2021-04-25 15:00:00,20364,2751992,11306.0,1879743,8.0,996,32.0,194390.0,20396,2946382,11338,2074133,31710,4827057
133,2021-04-26 15:00:00,27593,2779585,33154.0,1912897,14.0,1010,199.0,194589.0,27792,2974174,33353,2107486,60960,4888017
134,2021-04-27 15:00:00,26987,2806572,33554.0,1946451,9.0,1019,1107.0,195696.0,28094,3002268,34661,2142147,61657,4949674
135,2021-04-28 15:00:00,29389,2835961,40153.0,1986604,15.0,1034,1384.0,197080.0,30773,3033041,41537,2183684,70941,5020615
136,2021-04-29 15:00:00,27426,2863387,40260.0,2026864,12.0,1046,1483.0,198563.0,28909,3061950,41743,2225427,69181,5089796
137,2021-04-30 15:00:00,28523,2891910,32861.0,2059725,40.0,1086,1664.0,200227.0,30187,3092137,34525,2259952,63088,5152884
138,2021-05-01 15:00:00,21130,2913040,27471.0,2087196,68.0,1154,1085.0,201312.0,22215,3114352,28556,2288508,49754,5202638
139,2021-05-02 15:00:00,10414,2923454,17240.0,2104436,6.0,1160,845.0,202157.0,11259,3125611,18085,2306593,28505,5231143
140,2021-05-03 15:00:00,12960,2936414,29163.0,2133599,32.0,1192,1939.0,204096.0,14899,3140510,31102,2337695,44094,5275237
141,2021-05-04 15:00:00,13809,2950223,39173.0,2172772,9.0,1201,1774.0,205870.0,15583,3156093,40947,2378642,54765,5330002
142,2021-05-05 15:00:00,19512,2969735,38390.0,2211162,22.0,1223,1977.0,207847.0,21489,3177582,40367,2419009,59901,5389903
143,2021-05-06 15:00:00,17117,2986852,40979.0,2252141,11.0,1234,1761.0,209608.0,18878,3196460,42740,2461749,59868,5449771
144,2021-05-07 15:00:00,17753,3004605,37507.0,2289648,17.0,1251,1985.0,211593.0,19738,3216198,39492,2501241,57262,5507033
145,2021-05-08 15:00:00,10923,3015528,31533.0,2321181,2.0,1253,1319.0,212912.0,12242,3228440,32852,2534093,43777,5550810
146,2021-05-09 15:00:00,5126,3020654,12367.0,2333548,9.0,1262,712.0,213624.0,5838,3234278,13079,2547172,18214,5569024
147,2021-05-10 15:00:00,9065,3029719,31336.0,2364884,13.0,1275,1398.0,215022.0,10463,3244741,32734,2579906,41812,5610836
148,2021-05-11 15:00:00,12340,3042059,30573.0,2395457,9.0,1284,1468.0,216490.0,13808,3258549,32041,2611947,44390,5655226
149,2021-05-12 15:00:00,14108,3056167,39118.0,2434575,15.0,1299,1959.0,218449.0,16067,3274616,41077,2653024,55200,5710426
150,2021-05-13 15:00:00,22018,3078185,33855.0,2468430,8.0,1307,1363.0,219812.0,23381,3297997,35218,2688242,57244,5767670
151,2021-05-14 15:00:00,24609,3102794,30435.0,2498865,11.0,1318,1797.0,221609.0,26406,3324403,32232,2720474,56852,5824522
152,2021-05-15 15:00:00,22248,3125042,25437.0,2524302,6.0,1324,1514.0,223123.0,23762,3348165,26951,2747425,49205,5873727
153,2021-05-16 15:00:00,9186,3134228,17707.0,2542009,5.0,1329,1128.0,224251.0,10314,3358479,18835,2766260,28026,5901753
154,2021-05-17 15:00:00,17047,3151275,28695.0,2570704,12.0,1341,1984.0,226235.0,19031,3377510,30679,2796939,47738,5949491
155,2021-05-18 15:00:00,21525,3172800,31068.0,2601772,4.0,1345,1969.0,228204.0,23494,3401004,33037,2829976,54566,6004057
156,2021-05-19 15:00:00,28040,3200840,32963.0,2634735,9.0,1354,1671.0,229875.0,29711,3430715,34634,2864610,62683,6066740
157,2021-05-20 15:00:00,21030,3221870,33739.0,2668474,10.0,1364,1982.0,231857.0,23012,3453727,35721,2900331,56761,6123501
158,2021-05-21 15:00:00,19392,3241262,30857.0,2699331,7.0,1371,1627.0,233484.0,21019,3474746,32484,2932815,51883,6175384
159,2021-05-22 15:00:00,17229,3258491,21059.0,2720390,7.0,1378,1278.0,234762.0,18507,3493253,22337,2955152,39573,6214957
160,2021-05-23 15:00:00,8894,3267385,11629.0,2732019,3.0,1381,984.0,235746.0,9878,3503131,12613,2967765,21510,6236467
161,2021-05-24 15:00:00,13730,3281115,18105.0,2750124,7.0,1388,1499.0,237245.0,15229,3518360,19604,2987369,33341,6269808
162,2021-05-25 15:00:00,13270,3294385,19010.0,2769134,6.0,1394,1344.0,238589.0,14614,3532974,20354,3007723,33630,6303438
163,2021-05-26 15:00:00,18621,3313006,20005.0,2789139,3.0,1397,1533.0,240122.0,20154,3553128,21538,3029261,40162,6343600
164,2021-05-27 15:00:00,11866,3324872,19023.0,2808162,4.0,1401,1146.0,241268.0,13012,3566140,20169,3049430,32039,6375639
165,2021-05-28 15:00:00,12567,3337439,20130.0,2828292,15.0,1416,1416.0,242684.0,13983,3580123,21546,3070976,34128,6409767
166,2021-05-29 15:00:00,9640,3347079,11903.0,2840195,7.0,1423,953.0,243637.0,10593,3590716,12856,3083832,22503,6432270
167,2021-05-30 15:00:00,5022,3352101,6538.0,2846733,1.0,1424,605.0,244242.0,5627,3596343,7143,3090975,12166,6444436
168,2021-05-31 15:00:00,1805,3353906,3772.0,2850505,20.0,1444,306.0,244548.0,2111,3598454,4078,3095053,5903,6450339
169,2021-06-01 15:00:00,10006,3363912,16814.0,2867319,34.0,1478,1177.0,245725.0,11183,3609637,17991,3113044,28031,6478370
170,2021-06-02 15:00:00,10424,3374336,17135.0,2884454,9.0,1487,986.0,246711.0,11410,3621047,18121,3131165,28554,6506924
171,2021-06-03 15:00:00,7997,3382333,21500.0,2905954,2.0,1489,1109.0,247820.0,9106,3630153,22609,3153774,30608,6537532
172,2021-06-04 15:00:00,8344,3390677,22659.0,2928613,7.0,1496,1137.0,248957.0,9481,3639634,23796,3177570,32147,6569679
173,2021-06-05 15:00:00,7117,3397794,19759.0,2948372,1.0,1497,736.0,249693.0,7853,3647487,20495,3198065,27613,6597292
174,2021-06-06 15:00:00,3485,3401279,7381.0,2955753,,1497,432.0,250125.0,3917,3651404,7813,3205878,11298,6608590
175,2021-06-07 15:00:00,6960,3408239,16035.0,2971788,9.0,1506,747.0,250872.0,7707,3659111,16782,3222660,23751,6632341
176,2021-06-08 15:00:00,6760,3414999,20023.0,2991811,5.0,1511,848.0,251720.0,7608,3666719,20871,3243531,27636,6659977
177,2021-06-09 15:00:00,8338,3423337,24399.0,3016210,1.0,1512,988.0,252708.0,9326,3676045,25387,3268918,33726,6693703
178,2021-06-10 15:00:00,7249,3430586,19401.0,3035611,1.0,1513,910.0,253618.0,8159,3684204,20311,3289229,27561,6721264
179,2021-06-11 15:00:00,7610,3438196,18020.0,3053631,4.0,1517,1137.0,254755.0,8747,3692951,19157,3308386,26771,6748035
180,2021-06-12 15:00:00,5336,3443532,15108.0,3068739,3.0,1520,617.0,255372.0,5953,3698904,15725,3324111,21064,6769099
181,2021-06-13 15:00:00,1977,3445509,7740.0,3076479,,1520,430.0,255802.0,2407,3701311,8170,3332281,10147,6779246
182,2021-06-14 15:00:00,5717,3451226,12067.0,3088546,8.0,1528,745.0,256547.0,6462,3707773,12812,3345093,18537,6797783
183,2021-06-15 15:00:00,5747,3456973,14590.0,3103136,3.0,1531,885.0,257432.0,6632,3714405,15475,3360568,21225,6819008
184,2021-06-16 15:00:00,8863,3465836,21922.0,3125058,3.0,1534,771.0,258203.0,9634,3724039,22693,3383261,31559,6850567
185,2021-06-17 15:00:00,6769,3472605,12614.0,3137672,2.0,1536,731.0,258934.0,7500,3731539,13345,3396606,20116,6870683
186,2021-06-18 15:00:00,6929,3479534,12997.0,3150669,4.0,1540,718.0,259652.0,7647,3739186,13715,3410321,20648,6891331
187,2021-06-19 15:00:00,4735,3484269,9574.0,3160243,2.0,1542,622.0,260274.0,5357,3744543,10196,3420517,14933,6906264
188,2021-06-20 15:00:00,2550,3486819,5130.0,3165373,1.0,1543,381.0,260655.0,2931,3747474,5511,3426028,8062,6914326
189,2021-06-21 15:00:00,5677,3492496,5453.0,3170826,5.0,1548,646.0,261301.0,6323,3753797,6099,3432127,11781,6926107
190,2021-06-22 15:00:00,5497,3497993,9256.0,3180082,1.0,1549,709.0,262010.0,6206,3760003,9965,3442092,15463,6941570
191,2021-06-23 15:00:00,6178,3504171,10554.0,3190636,5.0,1554,653.0,262663.0,6831,3766834,11207,3453299,17390,6958960
192,2021-06-24 15:00:00,6012,3510183,8353.0,3198989,3.0,1557,602.0,263265.0,6614,3773448,8955,3462254,14970,6973930
193,2021-06-25 15:00:00,5942,3516125,8861.0,3207850,4.0,1561,623.0,263888.0,6565,3780013,9484,3471738,15430,6989360
194,2021-06-26 15:00:00,3759,3519884,6410.0,3214260,,1561,407.0,264295.0,4166,3784179,6817,3478555,10576,6999936
195,2021-06-27 15:00:00,2833,3522717,3579.0,3217839,,1561,186.0,264481.0,3019,3787198,3765,3482320,6598,7006534
196,2021-06-28 15:00:00,5038,3527755,6532.0,3224371,7.0,1568,547.0,265028.0,5585,3792783,7079,3489399,12124,7018658
197,2021-06-29 15:00:00,5144,3532899,6619.0,3230990,5.0,1573,535.0,265563.0,5679,3798462,7154,3496553,12303,7030961
198,2021-06-30 15:00:00,5748,3538647,7608.0,3238598,4.0,1577,617.0,266180.0,6365,3804827,8225,3504778,13977,7044938
199,2021-07-01 15:00:00,5525,3544172,7154.0,3245752,11.0,1588,519.0,266699.0,6044,3810871,7673,3512451,13209,7058147
200,2021-07-02 15:00:00,5421,3549593,7010.0,3252762,2.0,1590,537.0,267236.0,5958,3816829,7547,3519998,12970,7071117
201,2021-07-03 15:00:00,3356,3552949,4157.0,3256919,1.0,1591,273.0,267509.0,3629,3820458,4430,3524428,7787,7078904
202,2021-07-04 15:00:00,509,3553458,557.0,3257476,,1591,72.0,267581.0,581,3821039,629,3525057,1138,7080042
203,2021-07-05 15:00:00,3836,3557294,3999.0,3261475,3.0,1594,297.0,267878.0,4133,3825172,4296,3529353,8135,7088177
204,2021-07-06 15:00:00,4547,3561841,6418.0,3267893,3.0,1597,465.0,268343.0,5012,3830184,6883,3536236,11433,7099610
205,2021-07-07 15:00:00,4552,3566393,6603.0,3274496,,1597,500.0,268843.0,5052,3835236,7103,3543339,11655,7111265
206,2021-07-08 15:00:00,4919,3571312,6300.0,3280796,3.0,1600,575.0,269418.0,5494,3840730,6875,3550214,11797,7123062
207,2021-07-09 15:00:00,5467,3576779,6858.0,3287654,1.0,1601,585.0,270003.0,6052,3846782,7443,3557657,12911,7135973
208,2021-07-10 15:00:00,3590,3580369,4508.0,3292162,,1601,319.0,270322.0,3909,3850691,4827,3562484,8417,7144390
209,2021-07-11 15:00:00,2727,3583096,2621.0,3294783,,1601,233.0,270555.0,2960,3853651,2854,3565338,5581,7149971
210,2021-07-12 15:00:00,4511,3587607,5229.0,3300012,6.0,1607,388.0,270943.0,4899,3858550,5617,3570955,10134,7160105
211,2021-07-13 15:00:00,4725,3592332,4885.0,3304897,3.0,1610,368.0,271311.0,5093,3863643,5253,3576208,9981,7170086
212,2021-07-14 15:00:00,4729,3597061,5430.0,3310327,4.0,1614,430.0,271741.0,5159,3868802,5860,3582068,10593,7180679
213,2021-07-15 15:00:00,4992,3602053,5142.0,3315469,1.0,1615,370.0,272111.0,5362,3874164,5512,3587580,10505,7191184
214,2021-07-16 15:00:00,6362,3608415,6005.0,3321474,1.0,1616,409.0,272520.0,6771,3880935,6414,3593994,12777,7203961
215,2021-07-17 15:00:00,3496,3611911,3610.0,3325084,1.0,1617,319.0,272839.0,3815,3884750,3929,3597923,7426,7211387
216,2021-07-18 15:00:00,2360,3614271,2419.0,3327503,,1617,119.0,272958.0,2479,3887229,2538,3600461,4898,7216285
217,2021-07-19 15:00:00,5246,3619517,4729.0,3332232,2.0,1619,395.0,273353.0,5641,3892870,5124,3605585,10372,7226657
218,2021-07-20 15:00:00,5435,3624952,4852.0,3337084,1.0,1620,371.0,273724.0,5806,3898676,5223,3610808,10659,7237316
219,2021-07-21 15:00:00,5799,3630751,5088.0,3342172,4.0,1624,424.0,274148.0,6223,3904899,5512,3616320,11315,7248631
220,2021-07-22 15:00:00,6140,3636891,4754.0,3346926,2.0,1626,475.0,274623.0,6615,3911514,5229,3621549,11371,7260002
221,2021-07-23 15:00:00,6987,3643878,4992.0,3351918,1.0,1627,510.0,275133.0,7497,3919011,5502,3627051,12490,7272492
222,2021-07-24 15:00:00,4349,3648227,3287.0,3355205,,1627,273.0,275406.0,4622,3923633,3560,3630611,7909,7280401
223,2021-07-25 15:00:00,3352,3651579,1154.0,3356359,,1627,144.0,275550.0,3496,3927129,1298,3631909,4650,7285051
224,2021-07-26 15:00:00,6326,3657905,4025.0,3360384,2.0,1629,427.0,275977.0,6753,3933882,4452,3636361,10780,7295831
225,2021-07-27 15:00:00,6731,3664636,4396.0,3364780,,1629,476.0,276453.0,7207,3941089,4872,3641233,11603,7307434
226,2021-07-28 15:00:00,7240,3671876,4272.0,3369052,4.0,1633,483.0,276936.0,7723,3948812,4755,3645988,11999,7319433
227,2021-07-29 15:00:00,7218,3679094,4432.0,3373484,3.0,1636,442.0,277378.0,7660,3956472,4874,3650862,12095,7331528
228,2021-07-30 15:00:00,7958,3687052,4953.0,3378437,1.0,1637,550.0,277928.0,8508,3964980,5503,3656365,13462,7344990
229,2021-07-31 15:00:00,4905,3691957,3160.0,3381597,2.0,1639,285.0,278213.0,5190,3970170,3445,3659810,8352,7353342
230,2021-08-01 15:00:00,3989,3695946,2269.0,3383866,214.0,1853,178.0,278391.0,4167,3974337,2447,3662257,6650,7359992
231,2021-08-02 15:00:00,7436,3703382,3974.0,3387840,146.0,1999,363.0,278754.0,7799,3982136,4337,3666594,11919,7371911
232,2021-08-03 15:00:00,7424,3710806,4198.0,3392038,109.0,2108,525.0,279279.0,7949,3990085,4723,3671317,12256,7384167
233,2021-08-04 15:00:00,7609,3718415,4226.0,3396264,113.0,2221,566.0,279845.0,8175,3998260,4792,3676109,12514,7396681
234,2021-08-05 15:00:00,8108,3726523,4436.0,3400700,107.0,2328,555.0,280400.0,8663,4006923,4991,3681100,13206,7409887
235,2021-08-06 15:00:00,8501,3735024,4874.0,3405574,149.0,2477,468.0,280868.0,8969,4015892,5342,3686442,13992,7423879
236,2021-08-07 15:00:00,5411,3740435,2922.0,3408496,100.0,2577,277.0,281145.0,5688,4021580,3199,3689641,8710,7432589
237,2021-08-08 15:00:00,4060,3744495,2111.0,3410607,76.0,2653,160.0,281305.0,4220,4025800,2271,3691912,6407,7438996
238,2021-08-09 15:00:00,7103,3751598,4679.0,3415286,112.0,2765,390.0,281695.0,7493,4033293,5069,3696981,12284,7451280
239,2021-08-10 15:00:00,7305,3758903,4628.0,3419914,128.0,2893,355.0,282050.0,7660,4040953,4983,3701964,12416,7463696
240,2021-08-11 15:00:00,7270,3766173,4599.0,3424513,123.0,3016,460.0,282510.0,7730,4048683,5059,3707023,12452,7476148
241,2021-08-12 15:00:00,8806,3774979,4893.0,3429406,164.0,3180,472.0,282982.0,9278,4057961,5365,3712388,14335,7490483
242,2021-08-13 15:00:00,7328,3782307,5531.0,3434937,216.0,3396,418.0,283400.0,7746,4065707,5949,3718337,13493,7503976
243,2021-08-14 15:00:00,5017,3787324,3428.0,3438365,700.0,4096,302.0,283702.0,5319,4071026,3730,3722067,9447,7513423
244,2021-08-15 15:00:00,3389,3790713,2818.0,3441183,592.0,4688,175.0,283877.0,3564,4074590,2993,3725060,6974,7520397
245,2021-08-16 15:00:00,5610,3796323,5217.0,3446400,1284.0,5972,375.0,284252.0,5985,4080575,5592,3730652,12486,7532883
246,2021-08-17 15:00:00,6977,3803300,5519.0,3451919,1487.0,7459,397.0,284649.0,7374,4087949,5916,3736568,14380,7547263
247,2021-08-18 15:00:00,6516,3809816,5734.0,3457653,1704.0,9163,491.0,285140.0,7007,4094956,6225,3742793,14445,7561708
248,2021-08-19 15:00:00,6354,3816170,5726.0,3463379,1678.0,10841,428.0,285568.0,6782,4101738,6154,3748947,14186,7575894
249,2021-08-20 15:00:00,7001,3823171,6747.0,3470126,1785.0,12626,417.0,285985.0,7418,4109156,7164,3756111,15950,7591844
250,2021-08-21 15:00:00,4433,3827604,4037.0,3474163,913.0,13539,240.0,286225.0,4673,4113829,4277,3760388,9623,7601467
251,2021-08-22 15:00:00,3122,3830726,3253.0,3477416,833.0,14372,119.0,286344.0,3241,4117070,3372,3763760,7327,7608794
252,2021-08-23 15:00:00,6121,3836847,6287.0,3483703,1851.0,16223,298.0,286642.0,6419,4123489,6585,3770345,14557,7623351
253,2021-08-24 15:00:00,6701,3843548,6238.0,3489941,1777.0,18000,441.0,287083.0,7142,4130631,6679,3777024,15157,7638508
254,2021-08-25 15:00:00,6870,3850418,6418.0,3496359,1651.0,19651,456.0,287539.0,7326,4137957,6874,3783898,15395,7653903
255,2021-08-26 15:00:00,7102,3857520,6822.0,3503181,1783.0,21434,439.0,287978.0,7541,4145498,7261,3791159,16146,7670049
256,2021-08-27 15:00:00,6995,3864515,7271.0,3510452,2052.0,23486,333.0,288311.0,7328,4152826,7604,3798763,16651,7686700
257,2021-08-28 15:00:00,7007,3871522,6660.0,3517112,1035.0,24521,339.0,288650.0,7346,4160172,6999,3805762,15041,7701741
258,2021-08-29 15:00:00,3800,3875322,3769.0,3520881,705.0,25226,617.0,289267.0,4417,4164589,4386,3810148,8891,7710632
259,2021-08-30 15:00:00,6053,3881375,6322.0,3527203,1588.0,26814,978.0,290245.0,7031,4171620,7300,3817448,14941,7725573
260,2021-08-31 15:00:00,6064,3887439,6254.0,3533457,1716.0,28530,962.0,291207.0,7026,4178646,7216,3824664,14996,7740569
261,2021-09-01 15:00:00,5789,3893228,5959.0,3539416,1893.0,30423,935.0,292142.0,6724,4185370,6894,3831558,14576,7755145
262,2021-09-02 15:00:00,5627,3898855,6140.0,3545556,1905.0,32328,713.0,292855.0,6340,4191710,6853,3838411,14385,7769530
263,2021-09-03 15:00:00,6134,3904989,7123.0,3552679,1907.0,34235,983.0,293838.0,7117,4198827,8106,3846517,16147,7785677
264,2021-09-04 15:00:00,3799,3908788,4441.0,3557120,919.0,35154,890.0,294728.0,4689,4203516,5331,3851848,10049,7795726
265,2021-09-05 15:00:00,3001,3911789,2885.0,3560005,684.0,35838,120.0,294848.0,3121,4206637,3005,3854853,6690,7802416
266,2021-09-06 15:00:00,1075,3912864,1191.0,3561196,232.0,36070,76.0,294924.0,1151,4207788,1267,3856120,2574,7804990
267,2021-09-07 15:00:00,5465,3918329,7521.0,3568717,1469.0,37539,2318.0,297242.0,7783,4215571,9839,3865959,16773,7821763
268,2021-09-08 15:00:00,4798,3923127,5720.0,3574437,1605.0,39144,375.0,297617.0,5173,4220744,6095,3872054,12498,7834261
269,2021-09-09 15:00:00,5154,3928281,5602.0,3580039,2354.0,41498,343.0,297960.0,5497,4226241,5945,3877999,13453,7847714
270,2021-09-10 15:00:00,6631,3934912,6836.0,3586875,2557.0,44055,1738.0,299698.0,8369,4234610,8574,3886573,17762,7865476
271,2021-09-11 15:00:00,4252,3939164,4460.0,3591335,1034.0,45089,684.0,300382.0,4936,4239546,5144,3891717,10430,7875906
272,2021-09-12 15:00:00,3235,3942399,3319.0,3594654,714.0,45803,448.0,300830.0,3683,4243229,3767,3895484,7716,7883622
273,2021-09-13 15:00:00,4979,3947378,5223.0,3599877,1572.0,47375,361.0,301191.0,5340,4248569,5584,3901068,12135,7895757
274,2021-09-14 15:00:00,4847,3952225,5612.0,3605489,1652.0,49027,457.0,301648.0,5304,4253873,6069,3907137,12568,7908325
275,2021-09-15 15:00:00,5139,3957364,6070.0,3611559,1546.0,50573,409.0,302057.0,5548,4259421,6479,3913616,13164,7921489
276,2021-09-16 15:00:00,4875,3962239,5988.0,3617547,1657.0,52230,356.0,302413.0,5231,4264652,6344,3919960,12876,7934365
277,2021-09-17 15:00:00,5368,3967607,6760.0,3624307,1993.0,54223,362.0,302775.0,5730,4270382,7122,3927082,14483,7948848
278,2021-09-18 15:00:00,3883,3971490,4723.0,3629030,953.0,55176,197.0,302972.0,4080,4274462,4920,3932002,9756,7958604
279,2021-09-19 15:00:00,2785,3974275,3248.0,3632278,712.0,55888,85.0,303057.0,2870,4277332,3333,3935335,6830,7965434
280,2021-09-20 15:00:00,3793,3978068,4835.0,3637113,1813.0,57701,437.0,303494.0,4230,4281562,5272,3940607,10878,7976312
281,2021-09-21 15:00:00,4053,3982121,5159.0,3642272,1916.0,59617,350.0,303844.0,4403,4285965,5509,3946116,11478,7987790
282,2021-09-22 15:00:00,4281,3986402,4959.0,3647231,1785.0,61402,468.0,304312.0,4749,4290714,5427,3951543,11493,7999283
283,2021-09-23 15:00:00,4242,3990644,4831.0,3652062,2248.0,63650,501.0,304813.0,4743,4295457,5332,3956875,11822,8011105
284,2021-09-24 15:00:00,5168,3995812,5774.0,3657836,4917.0,68567,435.0,305248.0,5603,4301060,6209,3963084,16294,8027399
285,2021-09-25 15:00:00,3672,3999484,3729.0,3661565,4987.0,73554,385.0,305633.0,4057,4305117,4114,3967198,12773,8040172
286,2021-09-26 15:00:00,2355,4001839,2735.0,3664300,3139.0,76693,442.0,306075.0,2797,4307914,3177,3970375,8671,8048843
287,2021-09-27 15:00:00,4535,4006374,2793.0,3667093,8989.0,85682,521.0,306596.0,5056,4312970,3314,3973689,16838,8065681
288,2021-09-28 15:00:00,4444,4010818,4612.0,3671705,9823.0,95505,216.0,306812.0,4660,4317630,4828,3978517,19095,8084776
289,2021-09-29 15:00:00,4748,4015566,4676.0,3676381,10009.0,105514,921.0,307733.0,5669,4323299,5597,3984114,20354,8105130
290,2021-09-30 15:00:00,4932,4020498,4710.0,3681091,10102.0,115616,806.0,308539.0,5738,4329037,5516,3989630,20550,8125680
291,2021-10-01 15:00:00,5586,4026084,5505.0,3686596,12318.0,127934,802.0,309341.0,6388,4335425,6307,3995937,24211,8149891
292,2021-10-02 15:00:00,2962,4029046,2979.0,3689575,5868.0,133802,193.0,309534.0,3155,4338580,3172,3999109,12002,8161893
293,2021-10-03 15:00:00,2088,4031134,2419.0,3691994,3533.0,137335,90.0,309624.0,2178,4340758,2509,4001618,8130,8170023
294,2021-10-04 15:00:00,4048,4035182,3603.0,3695597,9999.0,147334,260.0,309884.0,4308,4345066,3863,4005481,17910,8187933
295,2021-10-05 15:00:00,3969,4039151,3797.0,3699394,10398.0,157732,223.0,310107.0,4192,4349258,4020,4009501,18387,8206320
296,2021-10-06 15:00:00,4088,4043239,3709.0,3703103,9159.0,166891,271.0,310378.0,4359,4353617,3980,4013481,17227,8223547
297,2021-10-07 15:00:00,4259,4047498,3753.0,3706856,10148.0,177039,345.0,310723.0,4604,4358221,4098,4017579,18505,8242052
298,2021-10-08 15:00:00,4815,4052313,4438.0,3711294,11759.0,188798,297.0,311020.0,5112,4363333,4735,4022314,21309,8263361
299,2021-10-09 15:00:00,2735,4055048,2757.0,3714051,4397.0,193195,276.0,311296.0,3011,4366344,3033,4025347,10165,8273526
300,2021-10-10 15:00:00,1867,4056915,1907.0,3715958,3654.0,196849,63.0,311359.0,1930,4368274,1970,4027317,7491,8281017
301,2021-10-11 15:00:00,4233,4061148,3406.0,3719364,9409.0,206258,262.0,311621.0,4495,4372769,3668,4030985,17310,8298327
302,2021-10-12 15:00:00,3649,4064797,3638.0,3723002,9971.0,216229,285.0,311906.0,3934,4376703,3923,4034908,17543,8315870
303,2021-10-13 15:00:00,4049,4068846,3624.0,3726626,9238.0,225467,364.0,312270.0,4413,4381116,3988,4038896,17275,8333145
304,2021-10-14 15:00:00,5185,4074031,5578.0,3732204,9691.0,235158,438.0,312708.0,5623,4386739,6016,4044912,20892,8354037
305,2021-10-15 15:00:00,4803,4078834,4757.0,3736961,10921.0,246079,355.0,313063.0,5158,4391897,5112,4050024,20836,8374873
306,2021-10-16 15:00:00,2532,4081366,2593.0,3739554,4773.0,250852,298.0,313361.0,2830,4394727,2891,4052915,10196,8385069
307,2021-10-17 15:00:00,1827,4083193,1804.0,3741358,2845.0,253697,59.0,313420.0,1886,4396613,1863,4054778,6535,8391604
308,2021-10-18 15:00:00,4301,4087494,3658.0,3745016,9436.0,263133,287.0,313707.0,4588,4401201,3945,4058723,17682,8409286
309,2021-10-19 15:00:00,4314,4091808,4123.0,3749139,9806.0,272939,231.0,313938.0,4545,4405746,4354,4063077,18474,8427760
310,2021-10-20 15:00:00,3593,4095401,3538.0,3752677,9281.0,282220,269.0,314207.0,3862,4409608,3807,4066884,16681,8444441
311,2021-10-21 15:00:00,3347,4098748,3358.0,3756035,10196.0,292416,294.0,314501.0,3641,4413249,3652,4070536,17195,8461636
312,2021-10-22 15:00:00,4654,4103402,4104.0,3760139,19155.0,311571,484.0,314985.0,5138,4418387,4588,4075124,28397,8490033
313,2021-10-23 15:00:00,2878,4106280,2167.0,3762306,11289.0,322860,329.0,315314.0,3207,4421594,2496,4077620,16663,8506696
314,2021-10-24 15:00:00,2036,4108316,1587.0,3763893,7354.0,330214,83.0,315397.0,2119,4423713,1670,4079290,11060,8517756
315,2021-10-25 15:00:00,4513,4112829,3115.0,3767008,23651.0,353865,325.0,315722.0,4838,4428551,3440,4082730,31604,8549360
316,2021-10-26 15:00:00,4460,4117289,3098.0,3770106,25877.0,379742,313.0,316035.0,4773,4433324,3411,4086141,33748,8583108
317,2021-10-27 15:00:00,4676,4121965,3395.0,3773501,25901.0,405643,429.0,316464.0,5105,4438429,3824,4089965,34401,8617509
318,2021-10-28 15:00:00,4480,4126445,3388.0,3776889,26858.0,432501,499.0,316963.0,4979,4443408,3887,4093852,35225,8652734
319,2021-10-29 15:00:00,4927,4131372,3968.0,3780857,26762.0,459263,393.0,317356.0,5320,4448728,4361,4098213,36050,8688784
320,2021-10-30 15:00:00,2576,4133948,1868.0,3782725,13854.0,473117,307.0,317663.0,2883,4451611,2175,4100388,18605,8707389
321,2021-10-31 15:00:00,1893,4135841,1526.0,3784251,7921.0,481038,94.0,317757.0,1987,4453598,1620,4102008,11434,8718823
322,2021-11-01 15:00:00,4709,4140550,3494.0,3787745,26426.0,507464,351.0,318108.0,5060,4458658,3845,4105853,34980,8753803
323,2021-11-02 15:00:00,4179,4144729,2969.0,3790714,26427.0,533891,411.0,318519.0,4590,4463248,3380,4109233,33986,8787789
324,2021-11-03 15:00:00,4622,4149351,3100.0,3793814,26536.0,560427,461.0,318980.0,5083,4468331,3561,4112794,34719,8822508
325,2021-11-04 15:00:00,6261,4155612,3385.0,3797199,27618.0,588045,530.0,319510.0,6791,4475122,3915,4116709,37794,8860302
326,2021-11-05 15:00:00,8170,4163782,3813.0,3801012,28563.0,616608,412.0,319922.0,8582,4483704,4225,4120934,40958,8901260
327,2021-11-06 15:00:00,10154,4173936,1986.0,3802998,13156.0,629764,309.0,320231.0,10463,4494167,2295,4123229,25605,8926865
328,2021-11-07 15:00:00,7865,4181801,1468.0,3804466,7502.0,637266,111.0,320342.0,7976,4502143,1579,4124808,16946,8943811
329,2021-11-08 15:00:00,11341,4193142,3118.0,3807584,20019.0,657285,379.0,320721.0,11720,4513863,3497,4128305,34857,8978668
330,2021-11-09 15:00:00,11752,4204894,2654.0,3810238,23481.0,680766,267.0,320988.0,12019,4525882,2921,4131226,38154,9016822
331,2021-11-10 15:00:00,12623,4217517,2828.0,3813066,24127.0,704893,354.0,321342.0,12977,4538859,3182,4134408,39932,9056754
332,2021-11-11 15:00:00,11403,4228920,2379.0,3815445,22438.0,727331,278.0,321620.0,11681,4550540,2657,4137065,36498,9093252
333,2021-11-12 15:00:00,12365,4241285,3394.0,3818839,26599.0,753930,545.0,322165.0,12910,4563450,3939,4141004,42903,9136155
334,2021-11-13 15:00:00,9972,4251257,1604.0,3820443,12630.0,766560,343.0,322508.0,10315,4573765,1947,4142951,24549,9160704
335,2021-11-14 15:00:00,4208,4255465,1117.0,3821560,7438.0,773998,121.0,322629.0,4329,4578094,1238,4144189,12884,9173588
336,2021-11-15 15:00:00,8609,4264074,2549.0,3824109,21259.0,795257,209.0,322838.0,8818,4586912,2758,4146947,32626,9206214
337,2021-11-16 15:00:00,9282,4273356,2542.0,3826651,23521.0,818778,259.0,323097.0,9541,4596453,2801,4149748,35604,9241818
338,2021-11-17 15:00:00,9395,4282751,2918.0,3829569,23162.0,841940,313.0,323410.0,9708,4606161,3231,4152979,35788,9277606
339,2021-11-18 15:00:00,9281,4292032,2652.0,3832221,23214.0,865154,486.0,323896.0,9767,4615928,3138,4156117,35633,9313239
340,2021-11-19 15:00:00,9835,4301867,2977.0,3835198,28261.0,893415,397.0,324293.0,10232,4626160,3374,4159491,41470,9354709
341,2021-11-20 15:00:00,10646,4312513,1627.0,3836825,14755.0,908170,455.0,324748.0,11101,4637261,2082,4161573,27483,9382192
342,2021-11-21 15:00:00,4372,4316885,1220.0,3838045,10150.0,918320,99.0,324847.0,4471,4641732,1319,4162892,15841,9398033
343,2021-11-22 15:00:00,9776,4326661,2539.0,3840584,25300.0,943620,292.0,325139.0,10068,4651800,2831,4165723,37907,9435940
344,2021-11-23 15:00:00,9189,4335850,2407.0,3842991,25560.0,969180,320.0,325459.0,9509,4661309,2727,4168450,37476,9473416
345,2021-11-24 15:00:00,8155,4344005,2474.0,3845465,20714.0,989894,220.0,325679.0,8375,4669684,2694,4171144,31563,9504979
346,2021-11-25 15:00:00,233,4344238,91.0,3845556,624.0,990518,10.0,325689.0,243,4669927,101,4171245,958,9505937
347,2021-11-26 15:00:00,5603,4349841,4004.0,3849560,16251.0,1006769,155.0,325844.0,5758,4675685,4159,4175404,26013,9531950
348,2021-11-27 15:00:00,3707,4353548,5499.0,3855059,11417.0,1018186,134.0,325978.0,3841,4679526,5633,4181037,20757,9552707
349,2021-11-28 15:00:00,2358,4355906,6436.0,3861495,7818.0,1026004,77.0,326055.0,2435,4681961,6513,4187550,16689,9569396
350,2021-11-29 15:00:00,6308,4362214,9437.0,3870932,19477.0,1045481,383.0,326438.0,6691,4688652,9820,4197370,35605,9605001
351,2021-11-30 15:00:00,6222,4368436,9468.0,3880400,23546.0,1069027,263.0,326701.0,6485,4695137,9731,4207101,39499,9644500
352,2021-12-01 15:00:00,7301,4375737,9946.0,3890346,26636.0,1095663,313.0,327014.0,7614,4702751,10259,4217360,44196,9688696
353,2021-12-02 15:00:00,6905,4382642,8922.0,3899268,27939.0,1123602,465.0,327479.0,7370,4710121,9387,4226747,44231,9732927
354,2021-12-03 15:00:00,7579,4390221,9474.0,3908742,31595.0,1155197,254.0,327733.0,7833,4717954,9728,4236475,48902,9781829
355,2021-12-04 15:00:00,5855,4396076,10262.0,3919004,17465.0,1172662,464.0,328197.0,6319,4724273,10726,4247201,34046,9815875
356,2021-12-05 15:00:00,3376,4399452,3595.0,3922599,10098.0,1182760,79.0,328276.0,3455,4727728,3674,4250875,17148,9833023
357,2021-12-06 15:00:00,6742,4406194,7167.0,3929766,25318.0,1208078,292.0,328568.0,7034,4734762,7459,4258334,39519,9872542
358,2021-12-07 15:00:00,6379,4412573,7130.0,3936896,26226.0,1234304,259.0,328827.0,6638,4741400,7389,4265723,39994,9912536
359,2021-12-08 15:00:00,6884,4419457,7516.0,3944412,25464.0,1259768,317.0,329144.0,7201,4748601,7833,4273556,40181,9952717
360,2021-12-09 15:00:00,6487,4425944,7142.0,3951554,26222.0,1285990,407.0,329551.0,6894,4755495,7549,4281105,40258,9992975
361,2021-12-10 15:00:00,7191,4433135,7404.0,3958958,27840.0,1313830,267.0,329818.0,7458,4762953,7671,4288776,42702,10035677
362,2021-12-11 15:00:00,4395,4437530,7774.0,3966732,15038.0,1328868,331.0,330149.0,4726,4767679,8105,4296881,27538,10063215
363,2021-12-12 15:00:00,3961,4441491,2824.0,3969556,8248.0,1337116,69.0,330218.0,4030,4771709,2893,4299774,15102,10078317
364,2021-12-13 15:00:00,5681,4447172,5859.0,3975415,23010.0,1360126,242.0,330460.0,5923,4777632,6101,4305875,34792,10113109
365,2021-12-14 15:00:00,6373,4453545,6025.0,3981440,24439.0,1384565,223.0,330683.0,6596,4784228,6248,4312123,37060,10150169
366,2021-12-15 15:00:00,7126,4460671,5817.0,3987257,22933.0,1407498,257.0,330940.0,7383,4791611,6074,4318197,36133,10186302
367,2021-12-16 15:00:00,7811,4468482,2860.0,3990117,26268.0,1433766,421.0,331361.0,8232,4799843,3281,4321478,37360,10223662
368,2021-12-17 15:00:00,7736,4476218,4216.0,3994333,27550.0,1461316,196.0,331557.0,7932,4807775,4412,4325890,39698,10263360
369,2021-12-18 15:00:00,5822,4482040,3248.0,3997581,16185.0,1477501,298.0,331855.0,6120,4813895,3546,4329436,25553,10288913
370,2021-12-19 15:00:00,3305,4485345,1349.0,3998930,9983.0,1487484,38.0,331893.0,3343,4817238,1387,4330823,14675,10303588
371,2021-12-20 15:00:00,7964,4493309,3783.0,4002713,27640.0,1515124,171.0,332064.0,8135,4825373,3954,4334777,39558,10343146
372,2021-12-21 15:00:00,8928,4502237,4247.0,4006960,28286.0,1543410,188.0,332252.0,9116,4834489,4435,4339212,41649,10384795
373,2021-12-22 15:00:00,8623,4510860,3987.0,4010947,28324.0,1571734,190.0,332442.0,8813,4843302,4177,4343389,41124,10425919
374,2021-12-23 15:00:00,8315,4519175,3632.0,4014579,23866.0,1595600,359.0,332801.0,8674,4851976,3991,4347380,36172,10462091
375,2021-12-24 15:00:00,1605,4520780,1028.0,4015607,4848.0,1600448,39.0,332840.0,1644,4853620,1067,4348447,7520,10469611
376,2021-12-25 15:00:00,50,4520830,37.0,4015644,286.0,1600734,1.0,332841.0,51,4853671,38,4348485,374,10469985
377,2021-12-26 15:00:00,2470,4523300,1761.0,4017405,7196.0,1607930,43.0,332884.0,2513,4856184,1804,4350289,11470,10481455
378,2021-12-27 15:00:00,7176,4530476,4135.0,4021540,21571.0,1629501,294.0,333178.0,7470,4863654,4429,4354718,33176,10514631
379,2021-12-28 15:00:00,7907,4538383,3916.0,4025456,24403.0,1653904,181.0,333359.0,8088,4871742,4097,4358815,36407,10551038
380,2021-12-29 15:00:00,8239,4546622,4096.0,4029552,23175.0,1677079,155.0,333514.0,8394,4880136,4251,4363066,35665,10586703
381,2021-12-30 15:00:00,7403,4554025,3863.0,4033415,21656.0,1698735,287.0,333801.0,7690,4887826,4150,4367216,33209,10619912
382,2021-12-31 15:00:00,2571,4556596,1572.0,4034987,7372.0,1706107,92.0,333893.0,2663,4890489,1664,4368880,11607,10631519
383,2022-01-01 15:00:00,758,4557354,364.0,4035351,1925.0,1708032,33.0,333926.0,791,4891280,397,4369277,3080,10634599
384,2022-01-02 15:00:00,2195,4559549,1656.0,4037007,5571.0,1713603,48.0,333974.0,2243,4893523,1704,4370981,9470,10644069
385,2022-01-03 15:00:00,3366,4562915,2111.0,4039118,10839.0,1724442,227.0,334201.0,3593,4897116,2338,4373319,16543,10660612
386,2022-01-04 15:00:00,5843,4568758,3570.0,4042688,16120.0,1740562,165.0,334366.0,6008,4903124,3735,4377054,25698,10686310
387,2022-01-05 15:00:00,6857,4575615,4813.0,4047501,18294.0,1758856,177.0,334543.0,7034,4910158,4990,4382044,30141,10716451
388,2022-01-06 15:00:00,6771,4582386,4902.0,4052403,22409.0,1781265,265.0,334808.0,7036,4917194,5167,4387211,34347,10750798
389,2022-01-07 15:00:00,5973,4588359,3886.0,4056289,19670.0,1800935,160.0,334968.0,6133,4923327,4046,4391257,29689,10780487
390,2022-01-08 15:00:00,4735,4593094,3988.0,4060277,13334.0,1814269,77.0,335045.0,4812,4928139,4065,4395322,22134,10802621
391,2022-01-09 15:00:00,2731,4595825,2042.0,4062319,7592.0,1821861,154.0,335199.0,2885,4931024,2196,4397518,12519,10815140
392,2022-01-10 15:00:00,6297,4602122,3928.0,4066247,18827.0,1840688,159.0,335358.0,6456,4937480,4087,4401605,29211,10844351
393,2022-01-11 15:00:00,6513,4608635,4338.0,4070585,18132.0,1858820,143.0,335501.0,6656,4944136,4481,4406086,29126,10873477
394,2022-01-12 15:00:00,6831,4615466,4535.0,4075120,18718.0,1877538,223.0,335724.0,7054,4951190,4758,4410844,30307,10903784
395,2022-01-13 15:00:00,6696,4622162,4449.0,4079569,17400.0,1894938,149.0,335873.0,6845,4958035,4598,4415442,28694,10932478
396,2022-01-14 15:00:00,7254,4629416,3337.0,4082906,22087.0,1917025,256.0,336129.0,7510,4965545,3593,4419035,32934,10965412
397,2022-01-15 15:00:00,4274,4633690,1710.0,4084616,11644.0,1928669,71.0,336200.0,4345,4969890,1781,4420816,17699,10983111
398,2022-01-16 15:00:00,2188,4635878,1335.0,4085951,6249.0,1934918,116.0,336316.0,2304,4972194,1451,4422267,9888,10992999
399,2022-01-17 15:00:00,3599,4639477,2432.0,4088383,10233.0,1945151,74.0,336390.0,3673,4975867,2506,4424773,16338,11009337
400,2022-01-18 15:00:00,5268,4644745,4300.0,4092683,13351.0,1958502,103.0,336493.0,5371,4981238,4403,4429176,23022,11032359
401,2022-01-19 15:00:00,5331,4650076,4598.0,4097281,13345.0,1971847,97.0,336590.0,5428,4986666,4695,4433871,23371,11055730
402,2022-01-20 15:00:00,4540,4654616,3685.0,4100966,11929.0,1983776,174.0,336764.0,4714,4991380,3859,4437730,20328,11076058
403,2022-01-21 15:00:00,5600,4660216,2974.0,4103940,15066.0,1998842,124.0,336888.0,5724,4997104,3098,4440828,23764,11099822
404,2022-01-22 15:00:00,3450,4663666,1772.0,4105712,9031.0,2007873,134.0,337022.0,3584,5000688,1906,4442734,14387,11114209
405,2022-01-23 15:00:00,2018,4665684,1514.0,4107226,5790.0,2013663,31.0,337053.0,2049,5002737,1545,4444279,9353,11123562
406,2022-01-24 15:00:00,4119,4669803,2811.0,4110037,11482.0,2025145,91.0,337144.0,4210,5006947,2902,4447181,18503,11142065
407,2022-01-25 15:00:00,3823,4673626,3410.0,4113447,9354.0,2034499,93.0,337237.0,3916,5010863,3503,4450684,16680,11158745
408,2022-01-26 15:00:00,3919,4677545,3778.0,4117225,9243.0,2043742,96.0,337333.0,4015,5014878,3874,4454558,17036,11175781
409,2022-01-27 15:00:00,3787,4681332,3994.0,4121219,10364.0,2054106,189.0,337522.0,3976,5018854,4183,4458741,18334,11194115
410,2022-01-28 15:00:00,3861,4685193,3342.0,4124561,11380.0,2065486,76.0,337598.0,3937,5022791,3418,4462159,18659,11212774
411,2022-01-29 15:00:00,2292,4687485,2331.0,4126892,5952.0,2071438,116.0,337714.0,2408,5025199,2447,4464606,10691,11223465
412,2022-01-30 15:00:00,1532,4689017,1667.0,4128559,3799.0,2075237,16.0,337730.0,1548,5026747,1683,4466289,7014,11230479
413,2022-01-31 15:00:00,3001,4692018,3292.0,4131851,7706.0,2082943,58.0,337788.0,3059,5029806,3350,4469639,14057,11244536
414,2022-02-01 15:00:00,2649,4694667,3502.0,4135353,6882.0,2089825,75.0,337863.0,2724,5032530,3577,4473216,13108,11257644
415,2022-02-02 15:00:00,2832,4697499,3825.0,4139178,6718.0,2096543,79.0,337942.0,2911,5035441,3904,4477120,13454,11271098
416,2022-02-03 15:00:00,2747,4700246,3744.0,4142922,6966.0,2103509,43.0,337985.0,2790,5038231,3787,4480907,13500,11284598
417,2022-02-04 15:00:00,2758,4703004,4446.0,4147368,7860.0,2111369,128.0,338113.0,2886,5041117,4574,4485481,15192,11299790
418,2022-02-05 15:00:00,1891,4704895,2910.0,4150278,5077.0,2116446,112.0,338225.0,2003,5043120,3022,4488503,9990,11309780
419,2022-02-06 15:00:00,1072,4705967,1354.0,4151632,2488.0,2118934,26.0,338251.0,1098,5044218,1380,4489883,4940,11314720
420,2022-02-07 15:00:00,2069,4708036,2741.0,4154373,5308.0,2124242,51.0,338302.0,2120,5046338,2792,4492675,10169,11324889
421,2022-02-08 15:00:00,2087,4710123,3147.0,4157520,5301.0,2129543,61.0,338363.0,2148,5048486,3208,4495883,10596,11335485
422,2022-02-09 15:00:00,2205,4712328,3394.0,4160914,5949.0,2135492,81.0,338444.0,2286,5050772,3475,4499358,11629,11347114
423,2022-02-10 15:00:00,2101,4714429,2938.0,4163852,5901.0,2141393,55.0,338499.0,2156,5052928,2993,4502351,10995,11358109
424,2022-02-11 15:00:00,2501,4716930,3585.0,4167437,7721.0,2149114,127.0,338626.0,2628,5055556,3712,4506063,13934,11372043
425,2022-02-12 15:00:00,1693,4718623,2365.0,4169802,4605.0,2153719,97.0,338723.0,1790,5057346,2462,4508525,8760,11380803
426,2022-02-13 15:00:00,733,4719356,1103.0,4170905,1844.0,2155563,17.0,338740.0,750,5058096,1120,4509645,3697,11384500
427,2022-02-14 15:00:00,1507,4720863,2271.0,4173176,4084.0,2159647,89.0,338829.0,1596,5059692,2360,4512005,7951,11392451
428,2022-02-15 15:00:00,1946,4722809,2511.0,4175687,4076.0,2163723,52.0,338881.0,1998,5061690,2563,4514568,8585,11401036
429,2022-02-16 15:00:00,1737,4724546,2610.0,4178297,4171.0,2167894,57.0,338938.0,1794,5063484,2667,4517235,8575,11409611
430,2022-02-17 15:00:00,16904,4741450,13150.0,4191447,3981.0,2171875,500.0,339438.0,17404,5080888,13650,4530885,34535,11444146
431,2022-02-18 15:00:00,2093,4743543,2755.0,4194202,5063.0,2176938,58.0,339496.0,2151,5083039,2813,4533698,9969,11454115
432,2022-02-19 15:00:00,1259,4744802,1786.0,4195988,3188.0,2180126,45.0,339541.0,1304,5084343,1831,4535529,6278,11460393
433,2022-02-20 15:00:00,738,4745540,911.0,4196899,1829.0,2181955,19.0,339560.0,757,5085100,930,4536459,3497,11463890
434,2022-02-21 15:00:00,1355,4746895,1853.0,4198752,3184.0,2185139,42.0,339602.0,1397,5086497,1895,4538354,6434,11470324
435,2022-02-22 15:00:00,1514,4748409,2016.0,4200768,3281.0,2188420,40.0,339642.0,1554,5088051,2056,4540410,6851,11477175
436,2022-02-23 15:00:00,1641,4750050,2016.0,4202784,3412.0,2191832,42.0,339684.0,1683,5089734,2058,4542468,7111,11484286
437,2022-02-24 15:00:00,1596,4751646,1802.0,4204586,3169.0,2195001,42.0,339726.0,1638,5091372,1844,4544312,6609,11490895
438,2022-02-25 15:00:00,1768,4753414,1989.0,4206575,4394.0,2199395,79.0,339805.0,1847,5093219,2068,4546380,8230,11499125
439,2022-02-26 15:00:00,1243,4754657,1316.0,4207891,2868.0,2202263,51.0,339856.0,1294,5094513,1367,4547747,5478,11504603
440,2022-02-27 15:00:00,609,4755266,578.0,4208469,1457.0,2203720,20.0,339876.0,629,5095142,598,4548345,2664,11507267
441,2022-02-28 15:00:00,1359,4756625,1471.0,4209940,3285.0,2207005,41.0,339917.0,1400,5096542,1512,4549857,6156,11513423
442,2022-03-01 15:00:00,1419,4758044,1455.0,4211395,3114.0,2210119,33.0,339950.0,1452,5097994,1488,4551345,6021,11519444
443,2022-03-02 15:00:00,1250,4759294,1410.0,4212805,3239.0,2213358,74.0,340024.0,1324,5099318,1484,4552829,5973,11525417
444,2022-03-03 15:00:00,1341,4760635,1371.0,4214176,2874.0,2216232,42.0,340066.0,1383,5100701,1413,4554242,5628,11531045
445,2022-03-04 15:00:00,1542,4762177,1671.0,4215847,3916.0,2220148,54.0,340120.0,1596,5102297,1725,4555967,7183,11538228
446,2022-03-05 15:00:00,849,4763026,983.0,4216830,2106.0,2222254,29.0,340149.0,878,5103175,1012,4556979,3967,11542195
447,2022-03-06 15:00:00,480,4763506,526.0,4217356,1052.0,2223306,15.0,340164.0,495,5103670,541,4557520,2073,11544268
448,2022-03-07 15:00:00,974,4764480,929.0,4218285,2426.0,2225732,30.0,340194.0,1004,5104674,959,4558479,4359,11548627
449,2022-03-08 15:00:00,1144,4765624,1091.0,4219376,2613.0,2228345,33.0,340227.0,1177,5105851,1124,4559603,4881,11553508
450,2022-03-09 15:00:00,1008,4766632,1100.0,4220476,2367.0,2230712,48.0,340275.0,1056,5106907,1148,4560751,4523,11558031
451,2022-03-10 15:00:00,999,4767631,1064.0,4221540,2300.0,2233012,23.0,340298.0,1022,5107929,1087,4561838,4386,11562417
452,2022-03-11 15:00:00,1197,4768828,1481.0,4223021,3030.0,2236042,52.0,340350.0,1249,5109178,1533,4563371,5760,11568177
453,2022-03-12 15:00:00,484,4769312,621.0,4223642,1169.0,2237211,14.0,340364.0,498,5109676,635,4564006,2288,11570465
454,2022-03-13 15:00:00,431,4769743,504.0,4224146,868.0,2238079,12.0,340376.0,443,5110119,516,4564522,1815,11572280
455,2022-03-14 15:00:00,856,4770599,765.0,4224911,1778.0,2239857,27.0,340403.0,883,5111002,792,4565314,3426,11575706
456,2022-03-15 15:00:00,901,4771500,954.0,4225865,1994.0,2241851,18.0,340421.0,919,5111921,972,4566286,3867,11579573
457,2022-03-16 15:00:00,954,4772454,1020.0,4226885,2059.0,2243910,35.0,340456.0,989,5112910,1055,4567341,4068,11583641
458,2022-03-17 15:00:00,848,4773302,935.0,4227820,1949.0,2245859,31.0,340487.0,879,5113789,966,4568307,3763,11587404
459,2022-03-18 15:00:00,1134,4774436,1179.0,4228999,2613.0,2248472,39.0,340526.0,1173,5114962,1218,4569525,4965,11592369
460,2022-03-19 15:00:00,626,4775062,708.0,4229707,1487.0,2249959,29.0,340555.0,655,5115617,737,4570262,2850,11595219
461,2022-03-20 15:00:00,380,4775442,384.0,4230091,811.0,2250770,11.0,340566.0,391,5116008,395,4570657,1586,11596805
462,2022-03-21 15:00:00,786,4776228,768.0,4230859,1936.0,2252706,25.0,340591.0,811,5116819,793,4571450,3515,11600320
463,2022-03-22 15:00:00,838,4777066,984.0,4231843,2174.0,2254880,19.0,340610.0,857,5117676,1003,4572453,4015,11604335
464,2022-03-23 15:00:00,845,4777911,900.0,4232743,2238.0,2257118,27.0,340637.0,872,5118548,927,4573380,4010,11608345
465,2022-03-24 15:00:00,820,4778731,985.0,4233728,1982.0,2259100,34.0,340671.0,854,5119402,1019,4574399,3821,11612166
466,2022-03-25 15:00:00,872,4779603,1028.0,4234756,2554.0,2261654,40.0,340711.0,912,5120314,1068,4575467,4494,11616660
467,2022-03-26 15:00:00,550,4780153,548.0,4235304,1532.0,2263186,20.0,340731.0,570,5120884,568,4576035,2650,11619310
468,2022-03-27 15:00:00,260,4780413,310.0,4235614,770.0,2263956,18.0,340749.0,278,5121162,328,4576363,1358,11620668
469,2022-03-28 15:00:00,706,4781119,675.0,4236289,1683.0,2265639,19.0,340768.0,725,5121887,694,4577057,3083,11623751
470,2022-03-29 15:00:00,843,4781962,778.0,4237067,1783.0,2267422,27.0,340795.0,870,5122757,805,4577862,3431,11627182
471,2022-03-30 15:00:00,898,4782860,991.0,4238058,2239.0,2269661,22.0,340817.0,920,5123677,1013,4578875,4150,11631332
472,2022-03-31 15:00:00,1032,4783892,1216.0,4239274,2430.0,2272091,28.0,340845.0,1060,5124737,1244,4580119,4706,11636038
473,2022-04-01 15:00:00,1130,4785022,1427.0,4240701,2921.0,2275012,47.0,340892.0,1177,5125914,1474,4581593,5525,11641563
474,2022-04-02 15:00:00,631,4785653,736.0,4241437,1623.0,2276635,17.0,340909.0,648,5126562,753,4582346,3007,11644570
475,2022-04-03 15:00:00,405,4786058,506.0,4241943,926.0,2277561,21.0,340930.0,426,5126988,527,4582873,1858,11646428
476,2022-04-04 15:00:00,892,4786950,1026.0,4242969,2168.0,2279729,30.0,340960.0,922,5127910,1056,4583929,4116,11650544
477,2022-04-05 15:00:00,845,4787795,974.0,4243943,2057.0,2281786,18.0,340978.0,863,5128773,992,4584921,3894,11654438
478,2022-04-06 15:00:00,896,4788691,1095.0,4245038,2199.0,2283985,23.0,341001.0,919,5129692,1118,4586039,4213,11658651
479,2022-04-07 15:00:00,952,4789643,1037.0,4246075,2122.0,2286107,10.0,341011.0,962,5130654,1047,4587086,4121,11662772
480,2022-04-08 15:00:00,1016,4790659,1238.0,4247313,2535.0,2288642,23.0,341034.0,1039,5131693,1261,4588347,4812,11667584
481,2022-04-09 15:00:00,548,4791207,671.0,4247984,1265.0,2289907,10.0,341044.0,558,5132251,681,4589028,2494,11670078
482,2022-04-10 15:00:00,359,4791566,393.0,4248377,887.0,2290794,14.0,341058.0,373,5132624,407,4589435,1653,11671731
483,2022-04-11 15:00:00,886,4792452,953.0,4249330,1980.0,2292774,27.0,341085.0,913,5133537,980,4590415,3846,11675577
484,2022-04-12 15:00:00,957,4793409,1099.0,4250429,2328.0,2295102,23.0,341108.0,980,5134517,1122,4591537,4407,11679984
485,2022-04-13 15:00:00,406,4793815,526.0,4250955,1285.0,2296387,10.0,341118.0,416,5134933,536,4592073,2227,11682211
