,VACCINATION_DATE,FirstDailyDose,FirstDoseCumulative,SecondDailyDose,SecondDoseCumulative,AdditionalDailyDose,AdditionalDoseCumulative,SingleDailyDose,SingleDoseCumulative,AtleastOneVaccine,AtleastOneVaccineCumulative,CompletedVax,CompletedVaxCumulative,FirstSecondSingleVaccinations,FirstSecondSingleVaccinationsCumulative
0,2020-12-14 15:00:00,21,1659,,563,,2,,,21,1659,0,563,21,2157
1,2020-12-15 15:00:00,70,1729,3.0,566,,2,,,70,1729,3,566,73,2230
2,2020-12-16 15:00:00,701,2430,7.0,573,,2,,,701,2430,7,573,708,2938
3,2020-12-17 15:00:00,1286,3716,11.0,584,,2,,,1286,3716,11,584,1297,4235
4,2020-12-18 15:00:00,3148,6864,13.0,597,,2,,,3148,6864,13,597,3161,7396
5,2020-12-19 15:00:00,1006,7870,9.0,606,,2,,,1006,7870,9,606,1015,8411
6,2020-12-20 15:00:00,398,8268,6.0,612,,2,,,398,8268,6,612,404,8815
7,2020-12-21 15:00:00,3965,12233,27.0,639,,2,,,3965,12233,27,639,3992,12807
8,2020-12-22 15:00:00,6382,18615,33.0,672,,2,,,6382,18615,33,672,6415,19222
9,2020-12-23 15:00:00,5852,24467,45.0,717,,2,,,5852,24467,45,717,5897,25119
10,2020-12-24 15:00:00,2782,27249,17.0,734,,2,,,2782,27249,17,734,2799,27918
11,2020-12-25 15:00:00,1036,28285,4.0,738,,2,,,1036,28285,4,738,1040,28958
12,2020-12-26 15:00:00,1919,30204,10.0,748,,2,,,1919,30204,10,748,1929,30887
13,2020-12-27 15:00:00,1827,32031,13.0,761,,2,,,1827,32031,13,761,1840,32727
14,2020-12-28 15:00:00,9216,41247,62.0,823,,2,,,9216,41247,62,823,9278,42005
15,2020-12-29 15:00:00,11239,52486,60.0,883,,2,,,11239,52486,60,883,11299,53304
16,2020-12-30 15:00:00,12777,65263,105.0,988,1.0,3,,,12777,65263,105,988,12883,66187
17,2020-12-31 15:00:00,7684,72947,55.0,1043,,3,,,7684,72947,55,1043,7739,73926
18,2021-01-01 15:00:00,3714,76661,164.0,1207,8.0,11,,,3714,76661,164,1207,3886,77812
19,2021-01-02 15:00:00,3329,79990,38.0,1245,,11,,,3329,79990,38,1245,3367,81179
20,2021-01-03 15:00:00,3464,83454,86.0,1331,,11,,,3464,83454,86,1331,3550,84729
21,2021-01-04 15:00:00,13498,96952,370.0,1701,2.0,13,,,13498,96952,370,1701,13870,98599
22,2021-01-05 15:00:00,12646,109598,597.0,2298,1.0,14,,,12646,109598,597,2298,13244,111843
23,2021-01-06 15:00:00,15435,125033,980.0,3278,1.0,15,,,15435,125033,980,3278,16416,128259
24,2021-01-07 15:00:00,15249,140282,1905.0,5183,,15,,,15249,140282,1905,5183,17154,145413
25,2021-01-08 15:00:00,24215,164497,2940.0,8123,,15,,,24215,164497,2940,8123,27155,172568
26,2021-01-09 15:00:00,5439,169936,1036.0,9159,1.0,16,,,5439,169936,1036,9159,6476,179044
27,2021-01-10 15:00:00,3061,172997,403.0,9562,,16,,,3061,172997,403,9562,3464,182508
28,2021-01-11 15:00:00,13883,186880,3531.0,13093,2.0,18,,,13883,186880,3531,13093,17416,199924
29,2021-01-12 15:00:00,17653,204533,5650.0,18743,,18,,,17653,204533,5650,18743,23303,223227
30,2021-01-13 15:00:00,18874,223407,3993.0,22736,,18,,,18874,223407,3993,22736,22867,246094
31,2021-01-14 15:00:00,18210,241617,2014.0,24750,1.0,19,,,18210,241617,2014,24750,20225,266319
32,2021-01-15 15:00:00,19845,261462,2088.0,26838,3.0,22,,,19845,261462,2088,26838,21936,288255
33,2021-01-16 15:00:00,6124,267586,1661.0,28499,,22,,,6124,267586,1661,28499,7785,296040
34,2021-01-17 15:00:00,2185,269771,1491.0,29990,1.0,23,,,2185,269771,1491,29990,3677,299717
35,2021-01-18 15:00:00,7260,277031,3333.0,33323,3.0,26,,,7260,277031,3333,33323,10596,310313
36,2021-01-19 15:00:00,17215,294246,5512.0,38835,1.0,27,,,17215,294246,5512,38835,22728,333041
37,2021-01-20 15:00:00,21190,315436,5415.0,44250,2.0,29,,,21190,315436,5415,44250,26607,359648
38,2021-01-21 15:00:00,24154,339590,3941.0,48191,2.0,31,,,24154,339590,3941,48191,28097,387745
39,2021-01-22 15:00:00,28871,368461,3837.0,52028,,31,,,28871,368461,3837,52028,32708,420453
40,2021-01-23 15:00:00,10300,378761,2021.0,54049,1.0,32,,,10300,378761,2021,54049,12322,432775
41,2021-01-24 15:00:00,3428,382189,1764.0,55813,2.0,34,,,3428,382189,1764,55813,5194,437969
42,2021-01-25 15:00:00,16483,398672,8819.0,64632,2.0,36,,,16483,398672,8819,64632,25304,463273
43,2021-01-26 15:00:00,17760,416432,9177.0,73809,2.0,38,,,17760,416432,9177,73809,26939,490212
44,2021-01-27 15:00:00,24631,441063,12823.0,86632,2.0,40,,,24631,441063,12823,86632,37456,527668
45,2021-01-28 15:00:00,22983,464046,9487.0,96119,3.0,43,,,22983,464046,9487,96119,32473,560141
46,2021-01-29 15:00:00,25117,489163,8154.0,104273,9.0,52,,,25117,489163,8154,104273,33280,593421
47,2021-01-30 15:00:00,17996,507159,2759.0,107032,5.0,57,,,17996,507159,2759,107032,20760,614181
48,2021-01-31 15:00:00,3817,510976,1476.0,108508,5.0,62,,,3817,510976,1476,108508,5298,619479
49,2021-02-01 15:00:00,8410,519386,5629.0,114137,59.0,121,,,8410,519386,5629,114137,14098,633577
50,2021-02-02 15:00:00,12689,532075,14041.0,128178,6.0,127,,,12689,532075,14041,128178,26736,660313
51,2021-02-03 15:00:00,18478,550553,18367.0,146545,2.0,129,,,18478,550553,18367,146545,36847,697160
52,2021-02-04 15:00:00,22411,572964,16101.0,162646,3.0,132,,,22411,572964,16101,162646,38515,735675
53,2021-02-05 15:00:00,20648,593612,17793.0,180439,6.0,138,,,20648,593612,17793,180439,38447,774122
54,2021-02-06 15:00:00,11634,605246,14835.0,195274,7.0,145,,,11634,605246,14835,195274,26476,800598
55,2021-02-07 15:00:00,6047,611293,2010.0,197284,2.0,147,,,6047,611293,2010,197284,8059,808657
56,2021-02-08 15:00:00,13162,624455,13131.0,210415,12.0,159,,,13162,624455,13131,210415,26305,834962
57,2021-02-09 15:00:00,16953,641408,14120.0,224535,,159,,,16953,641408,14120,224535,31073,866035
58,2021-02-10 15:00:00,19540,660948,21589.0,246124,5.0,164,,,19540,660948,21589,246124,41134,907169
59,2021-02-11 15:00:00,23083,684031,17696.0,263820,8.0,172,,,23083,684031,17696,263820,40787,947956
60,2021-02-12 15:00:00,20654,704685,19950.0,283770,10.0,182,,,20654,704685,19950,283770,40614,988570
61,2021-02-13 15:00:00,11592,716277,6519.0,290289,1.0,183,,,11592,716277,6519,290289,18112,1006682
62,2021-02-14 15:00:00,7220,723497,2214.0,292503,3.0,186,,,7220,723497,2214,292503,9437,1016119
63,2021-02-15 15:00:00,11947,735444,13491.0,305994,16.0,202,,,11947,735444,13491,305994,25454,1041573
64,2021-02-16 15:00:00,16919,752363,21231.0,327225,7.0,209,,,16919,752363,21231,327225,38157,1079730
65,2021-02-17 15:00:00,20832,773195,26620.0,353845,8.0,217,,,20832,773195,26620,353845,47460,1127190
66,2021-02-18 15:00:00,3272,776467,4670.0,358515,5.0,222,,,3272,776467,4670,358515,7947,1135137
67,2021-02-19 15:00:00,10412,786879,20155.0,378670,8.0,230,,,10412,786879,20155,378670,30575,1165712
68,2021-02-20 15:00:00,10403,797282,20508.0,399178,4.0,234,,,10403,797282,20508,399178,30915,1196627
69,2021-02-21 15:00:00,6381,803663,7847.0,407025,8.0,242,,,6381,803663,7847,407025,14236,1210863
70,2021-02-22 15:00:00,8125,811788,15656.0,422681,15.0,257,,,8125,811788,15656,422681,23796,1234659
71,2021-02-23 15:00:00,15636,827424,16210.0,438891,6.0,263,,,15636,827424,16210,438891,31852,1266511
72,2021-02-24 15:00:00,18124,845548,25106.0,463997,8.0,271,,,18124,845548,25106,463997,43238,1309749
73,2021-02-25 15:00:00,20591,866139,26942.0,490939,8.0,279,,,20591,866139,26942,490939,47541,1357290
74,2021-02-26 15:00:00,26837,892976,26563.0,517502,15.0,294,,,26837,892976,26563,517502,53415,1410705
75,2021-02-27 15:00:00,16181,909157,11431.0,528933,8.0,302,,,16181,909157,11431,528933,27620,1438325
76,2021-02-28 15:00:00,15596,924753,4993.0,533926,22.0,324,,,15596,924753,4993,533926,20611,1458936
77,2021-03-01 15:00:00,27809,952562,12913.0,546839,65.0,389,,,27809,952562,12913,546839,40787,1499723
78,2021-03-02 15:00:00,24280,976842,13481.0,560320,9.0,398,39.0,39.0,24319,976881,13520,560359,37809,1537532
79,2021-03-03 15:00:00,30496,1007338,18632.0,578952,11.0,409,201.0,240.0,30697,1007578,18833,579192,49340,1586872
80,2021-03-04 15:00:00,31252,1038590,18497.0,597449,5.0,414,4074.0,4314.0,35326,1042904,22571,601763,53828,1640700
81,2021-03-05 15:00:00,30397,1068987,20003.0,617452,7.0,421,4950.0,9264.0,35347,1078251,24953,626716,55357,1696057
82,2021-03-06 15:00:00,19191,1088178,9717.0,627169,2.0,423,6119.0,15383.0,25310,1103561,15836,642552,35029,1731086
83,2021-03-07 15:00:00,12239,1100417,5001.0,632170,1.0,424,6666.0,22049.0,18905,1122466,11667,654219,23907,1754993
84,2021-03-08 15:00:00,26089,1126506,9001.0,641171,14.0,438,8368.0,30417.0,34457,1156923,17369,671588,43472,1798465
85,2021-03-09 15:00:00,26304,1152810,15668.0,656839,2.0,440,8432.0,38849.0,34736,1191659,24100,695688,50406,1848871
86,2021-03-10 15:00:00,30107,1182917,16270.0,673109,12.0,452,7983.0,46832.0,38090,1229749,24253,719941,54372,1903243
87,2021-03-11 15:00:00,36258,1219175,16566.0,689675,6.0,458,4026.0,50858.0,40284,1270033,20592,740533,56856,1960099
88,2021-03-12 15:00:00,37177,1256352,18388.0,708063,8.0,466,2977.0,53835.0,40154,1310187,21365,761898,58550,2018649
89,2021-03-13 15:00:00,22881,1279233,10484.0,718547,1.0,467,1671.0,55506.0,24552,1334739,12155,774053,35037,2053686
90,2021-03-14 15:00:00,17991,1297224,6883.0,725430,4.0,471,1034.0,56540.0,19025,1353764,7917,781970,25912,2079598
91,2021-03-15 15:00:00,30241,1327465,11541.0,736971,14.0,485,620.0,57160.0,30861,1384625,12161,794131,42416,2122014
92,2021-03-16 15:00:00,33765,1361230,13713.0,750684,14.0,499,800.0,57960.0,34565,1419190,14513,808644,48292,2170306
93,2021-03-17 15:00:00,37994,1399224,17301.0,767985,10.0,509,1199.0,59159.0,39193,1458383,18500,827144,56504,2226810
94,2021-03-18 15:00:00,41946,1441170,12899.0,780884,8.0,517,1365.0,60524.0,43311,1501694,14264,841408,56218,2283028
95,2021-03-19 15:00:00,38813,1479983,15613.0,796497,10.0,527,1064.0,61588.0,39877,1541571,16677,858085,55500,2338528
96,2021-03-20 15:00:00,25085,1505068,10379.0,806876,7.0,534,713.0,62301.0,25798,1567369,11092,869177,36184,2374712
97,2021-03-21 15:00:00,19381,1524449,7962.0,814838,10.0,544,349.0,62650.0,19730,1587099,8311,877488,27702,2402414
98,2021-03-22 15:00:00,32894,1557343,11636.0,826474,23.0,567,836.0,63486.0,33730,1620829,12472,889960,45389,2447803
99,2021-03-23 15:00:00,38752,1596095,18034.0,844508,5.0,572,1569.0,65055.0,40321,1661150,19603,909563,58360,2506163
100,2021-03-24 15:00:00,41499,1637594,21456.0,865964,13.0,585,1399.0,66454.0,42898,1704048,22855,932418,64367,2570530
101,2021-03-25 15:00:00,43284,1680878,21990.0,887954,6.0,591,2473.0,68927.0,45757,1749805,24463,956881,67753,2638283
102,2021-03-26 15:00:00,36836,1717714,26896.0,914850,7.0,598,2516.0,71443.0,39352,1789157,29412,986293,66255,2704538
103,2021-03-27 15:00:00,26831,1744545,17530.0,932380,8.0,606,2517.0,73960.0,29348,1818505,20047,1006340,46886,2751424
104,2021-03-28 15:00:00,17232,1761777,12789.0,945169,10.0,616,1619.0,75579.0,18851,1837356,14408,1020748,31650,2783074
105,2021-03-29 15:00:00,30054,1791831,26636.0,971805,16.0,632,1155.0,76734.0,31209,1868565,27791,1048539,57861,2840935
106,2021-03-30 15:00:00,40538,1832369,29331.0,1001136,6.0,638,1887.0,78621.0,42425,1910990,31218,1079757,71762,2912697
107,2021-03-31 15:00:00,41478,1873847,35090.0,1036226,18.0,656,5780.0,84401.0,47258,1958248,40870,1120627,82366,2995063
108,2021-04-01 15:00:00,43261,1917108,41645.0,1077871,81.0,737,5946.0,90347.0,49207,2007455,47591,1168218,90933,3085996
109,2021-04-02 15:00:00,35605,1952713,33052.0,1110923,14.0,751,6272.0,96619.0,41877,2049332,39324,1207542,74943,3160939
110,2021-04-03 15:00:00,21596,1974309,19508.0,1130431,4.0,755,4448.0,101067.0,26044,2075376,23956,1231498,45556,3206495
111,2021-04-04 15:00:00,8536,1982845,10309.0,1140740,3.0,758,991.0,102058.0,9527,2084903,11300,1242798,19839,3226334
112,2021-04-05 15:00:00,28235,2011080,29210.0,1169950,22.0,780,6753.0,108811.0,34988,2119891,35963,1278761,64220,3290554
113,2021-04-06 15:00:00,40129,2051209,30753.0,1200703,15.0,795,10598.0,119409.0,50727,2170618,41351,1320112,81495,3372049
114,2021-04-07 15:00:00,36553,2087762,34634.0,1235337,9.0,804,13148.0,132557.0,49701,2220319,47782,1367894,84344,3456393
115,2021-04-08 15:00:00,42673,2130435,36507.0,1271844,10.0,814,14024.0,146581.0,56697,2277016,50531,1418425,93214,3549607
116,2021-04-09 15:00:00,34524,2164959,36698.0,1308542,10.0,824,14650.0,161231.0,49174,2326190,51348,1469773,85882,3635489
117,2021-04-10 15:00:00,23896,2188855,23510.0,1332052,4.0,828,7797.0,169028.0,31693,2357883,31307,1501080,55207,3690696
118,2021-04-11 15:00:00,17709,2206564,13429.0,1345481,2.0,830,10247.0,179275.0,27956,2385839,23676,1524756,41387,3732083
119,2021-04-12 15:00:00,24882,2231446,33581.0,1379062,13.0,843,11121.0,190396.0,36003,2421842,44702,1569458,69597,3801680
120,2021-04-13 15:00:00,126531,2357977,91725.0,1470787,10.0,853,3309.0,193705.0,129840,2551682,95034,1664492,221575,4023255
121,2021-04-14 15:00:00,41349,2399326,38324.0,1509111,14.0,867,208.0,193913.0,41557,2593239,38532,1703024,79895,4103150
122,2021-04-15 15:00:00,41872,2441198,40044.0,1549155,21.0,888,169.0,194082.0,42041,2635280,40213,1743237,82106,4185256
123,2021-04-16 15:00:00,37601,2478799,39368.0,1588523,11.0,899,27.0,194109.0,37628,2672908,39395,1782632,77007,4262263
124,2021-04-17 15:00:00,33198,2511997,22431.0,1610954,13.0,912,13.0,194122.0,33211,2706119,22444,1805076,55655,4317918
125,2021-04-18 15:00:00,20180,2532177,16378.0,1627332,4.0,916,5.0,194127.0,20185,2726304,16383,1821459,36567,4354485
126,2021-04-19 15:00:00,30143,2562320,36912.0,1664244,17.0,933,62.0,194189.0,30205,2756509,36974,1858433,67134,4421619
127,2021-04-20 15:00:00,33218,2595538,44981.0,1709225,12.0,945,60.0,194249.0,33278,2789787,45041,1903474,78271,4499890
128,2021-04-21 15:00:00,40347,2635885,47566.0,1756791,15.0,960,24.0,194273.0,40371,2830158,47590,1951064,87952,4587842
129,2021-04-22 15:00:00,36242,2672127,43275.0,1800066,21.0,981,17.0,194290.0,36259,2866417,43292,1994356,79555,4667397
130,2021-04-23 15:00:00,33538,2705665,40768.0,1840834,9.0,990,14.0,194304.0,33552,2899969,40782,2035138,74329,4741726
131,2021-04-24 15:00:00,26704,2732369,28351.0,1869185,6.0,996,80.0,194384.0,26784,2926753,28431,2063569,55141,4796867
132,2021-04-25 15:00:00,20364,2752733,11311.0,1880496,8.0,1004,32.0,194416.0,20396,2947149,11343,2074912,31715,4828582
133,2021-04-26 15:00:00,27595,2780328,33156.0,1913652,14.0,1018,199.0,194615.0,27794,2974943,33355,2108267,60964,4889546
134,2021-04-27 15:00:00,26991,2807319,33561.0,1947213,9.0,1027,1107.0,195722.0,28098,3003041,34668,2142935,61668,4951214
135,2021-04-28 15:00:00,29389,2836708,40167.0,1987380,15.0,1042,1384.0,197106.0,30773,3033814,41551,2184486,70955,5022169
136,2021-04-29 15:00:00,27425,2864133,40276.0,2027656,12.0,1054,1483.0,198589.0,28908,3062722,41759,2226245,69196,5091365
137,2021-04-30 15:00:00,28525,2892658,32868.0,2060524,40.0,1094,1664.0,200253.0,30189,3092911,34532,2260777,63097,5154462
138,2021-05-01 15:00:00,21145,2913803,27491.0,2088015,67.0,1161,1086.0,201339.0,22231,3115142,28577,2289354,49789,5204251
139,2021-05-02 15:00:00,10416,2924219,17242.0,2105257,6.0,1167,845.0,202184.0,11261,3126403,18087,2307441,28509,5232760
140,2021-05-03 15:00:00,12958,2937177,29176.0,2134433,32.0,1199,1939.0,204123.0,14897,3141300,31115,2338556,44105,5276865
141,2021-05-04 15:00:00,13805,2950982,39176.0,2173609,9.0,1208,1774.0,205897.0,15579,3156879,40950,2379506,54764,5331629
142,2021-05-05 15:00:00,19514,2970496,38393.0,2212002,22.0,1230,1977.0,207874.0,21491,3178370,40370,2419876,59906,5391535
143,2021-05-06 15:00:00,17118,2987614,40982.0,2252984,11.0,1241,1761.0,209635.0,18879,3197249,42743,2462619,59872,5451407
144,2021-05-07 15:00:00,17754,3005368,37515.0,2290499,18.0,1259,1985.0,211620.0,19739,3216988,39500,2502119,57272,5508679
145,2021-05-08 15:00:00,10920,3016288,31539.0,2322038,2.0,1261,1320.0,212940.0,12240,3229228,32859,2534978,43781,5552460
146,2021-05-09 15:00:00,5126,3021414,12369.0,2334407,9.0,1270,712.0,213652.0,5838,3235066,13081,2548059,18216,5570676
147,2021-05-10 15:00:00,9067,3030481,31337.0,2365744,13.0,1283,1399.0,215051.0,10466,3245532,32736,2580795,41816,5612492
148,2021-05-11 15:00:00,12339,3042820,30584.0,2396328,9.0,1292,1468.0,216519.0,13807,3259339,32052,2612847,44400,5656892
149,2021-05-12 15:00:00,14110,3056930,39118.0,2435446,15.0,1307,1959.0,218478.0,16069,3275408,41077,2653924,55202,5712094
150,2021-05-13 15:00:00,22019,3078949,33859.0,2469305,8.0,1315,1363.0,219841.0,23382,3298790,35222,2689146,57249,5769343
151,2021-05-14 15:00:00,24611,3103560,30437.0,2499742,11.0,1326,1797.0,221638.0,26408,3325198,32234,2721380,56856,5826199
152,2021-05-15 15:00:00,22249,3125809,25438.0,2525180,6.0,1332,1514.0,223152.0,23763,3348961,26952,2748332,49207,5875406
153,2021-05-16 15:00:00,9186,3134995,17708.0,2542888,5.0,1337,1128.0,224280.0,10314,3359275,18836,2767168,28027,5903433
154,2021-05-17 15:00:00,17045,3152040,28701.0,2571589,12.0,1349,1984.0,226264.0,19029,3378304,30685,2797853,47742,5951175
155,2021-05-18 15:00:00,21524,3173564,31076.0,2602665,4.0,1353,1970.0,228234.0,23494,3401798,33046,2830899,54574,6005749
156,2021-05-19 15:00:00,28042,3201606,32964.0,2635629,9.0,1362,1670.0,229904.0,29712,3431510,34634,2865533,62685,6068434
157,2021-05-20 15:00:00,21035,3222641,33739.0,2669368,10.0,1372,1983.0,231887.0,23018,3454528,35722,2901255,56767,6125201
158,2021-05-21 15:00:00,19391,3242032,30867.0,2700235,7.0,1379,1627.0,233514.0,21018,3475546,32494,2933749,51892,6177093
159,2021-05-22 15:00:00,17230,3259262,21061.0,2721296,7.0,1386,1277.0,234791.0,18507,3494053,22338,2956087,39575,6216668
160,2021-05-23 15:00:00,8889,3268151,11633.0,2732929,3.0,1389,984.0,235775.0,9873,3503926,12617,2968704,21509,6238177
161,2021-05-24 15:00:00,13728,3281879,18109.0,2751038,8.0,1397,1499.0,237274.0,15227,3519153,19608,2988312,33344,6271521
162,2021-05-25 15:00:00,13273,3295152,19011.0,2770049,6.0,1403,1342.0,238616.0,14615,3533768,20353,3008665,33632,6305153
163,2021-05-26 15:00:00,18641,3313793,20005.0,2790054,3.0,1406,1533.0,240149.0,20174,3553942,21538,3030203,40182,6345335
164,2021-05-27 15:00:00,11869,3325662,19022.0,2809076,4.0,1410,1147.0,241296.0,13016,3566958,20169,3050372,32042,6377377
165,2021-05-28 15:00:00,12569,3338231,20135.0,2829211,15.0,1425,1416.0,242712.0,13985,3580943,21551,3071923,34135,6411512
166,2021-05-29 15:00:00,9641,3347872,11909.0,2841120,7.0,1432,953.0,243665.0,10594,3591537,12862,3084785,22510,6434022
167,2021-05-30 15:00:00,5022,3352894,6539.0,2847659,1.0,1433,604.0,244269.0,5626,3597163,7143,3091928,12166,6446188
168,2021-05-31 15:00:00,1806,3354700,3773.0,2851432,20.0,1453,306.0,244575.0,2112,3599275,4079,3096007,5905,6452093
169,2021-06-01 15:00:00,10011,3364711,16823.0,2868255,34.0,1487,1178.0,245753.0,11189,3610464,18001,3114008,28046,6480139
170,2021-06-02 15:00:00,10425,3375136,17138.0,2885393,9.0,1496,986.0,246739.0,11411,3621875,18124,3132132,28558,6508697
171,2021-06-03 15:00:00,8008,3383144,21503.0,2906896,2.0,1498,1110.0,247849.0,9118,3630993,22613,3154745,30623,6539320
172,2021-06-04 15:00:00,8349,3391493,22660.0,2929556,8.0,1506,1137.0,248986.0,9486,3640479,23797,3178542,32154,6571474
173,2021-06-05 15:00:00,7118,3398611,19760.0,2949316,1.0,1507,736.0,249722.0,7854,3648333,20496,3199038,27615,6599089
174,2021-06-06 15:00:00,3486,3402097,7383.0,2956699,,1507,432.0,250154.0,3918,3652251,7815,3206853,11301,6610390
175,2021-06-07 15:00:00,6961,3409058,16039.0,2972738,9.0,1516,747.0,250901.0,7708,3659959,16786,3223639,23756,6634146
176,2021-06-08 15:00:00,6760,3415818,20022.0,2992760,5.0,1521,848.0,251749.0,7608,3667567,20870,3244509,27635,6661781
177,2021-06-09 15:00:00,8340,3424158,24402.0,3017162,1.0,1522,989.0,252738.0,9329,3676896,25391,3269900,33732,6695513
178,2021-06-10 15:00:00,7248,3431406,19402.0,3036564,1.0,1523,910.0,253648.0,8158,3685054,20312,3290212,27561,6723074
179,2021-06-11 15:00:00,7608,3439014,18020.0,3054584,4.0,1527,1137.0,254785.0,8745,3693799,19157,3309369,26769,6749843
180,2021-06-12 15:00:00,5336,3444350,15109.0,3069693,3.0,1530,617.0,255402.0,5953,3699752,15726,3325095,21065,6770908
181,2021-06-13 15:00:00,1978,3446328,7738.0,3077431,,1530,430.0,255832.0,2408,3702160,8168,3333263,10146,6781054
182,2021-06-14 15:00:00,5717,3452045,12066.0,3089497,8.0,1538,745.0,256577.0,6462,3708622,12811,3346074,18536,6799590
183,2021-06-15 15:00:00,5745,3457790,14593.0,3104090,3.0,1541,885.0,257462.0,6630,3715252,15478,3361552,21226,6820816
184,2021-06-16 15:00:00,8865,3466655,21925.0,3126015,3.0,1544,771.0,258233.0,9636,3724888,22696,3384248,31564,6852380
185,2021-06-17 15:00:00,6767,3473422,12618.0,3138633,2.0,1546,731.0,258964.0,7498,3732386,13349,3397597,20118,6872498
186,2021-06-18 15:00:00,6928,3480350,13001.0,3151634,4.0,1550,718.0,259682.0,7646,3740032,13719,3411316,20651,6893149
187,2021-06-19 15:00:00,4735,3485085,9577.0,3161211,2.0,1552,622.0,260304.0,5357,3745389,10199,3421515,14936,6908085
188,2021-06-20 15:00:00,2552,3487637,5132.0,3166343,1.0,1553,381.0,260685.0,2933,3748322,5513,3427028,8066,6916151
189,2021-06-21 15:00:00,5678,3493315,5453.0,3171796,5.0,1558,646.0,261331.0,6324,3754646,6099,3433127,11782,6927933
190,2021-06-22 15:00:00,5499,3498814,9259.0,3181055,1.0,1559,709.0,262040.0,6208,3760854,9968,3443095,15468,6943401
191,2021-06-23 15:00:00,6180,3504994,10555.0,3191610,5.0,1564,653.0,262693.0,6833,3767687,11208,3454303,17393,6960794
192,2021-06-24 15:00:00,6013,3511007,8353.0,3199963,3.0,1567,602.0,263295.0,6615,3774302,8955,3463258,14971,6975765
193,2021-06-25 15:00:00,5946,3516953,8866.0,3208829,4.0,1571,622.0,263917.0,6568,3780870,9488,3472746,15438,6991203
194,2021-06-26 15:00:00,3760,3520713,6412.0,3215241,,1571,407.0,264324.0,4167,3785037,6819,3479565,10579,7001782
195,2021-06-27 15:00:00,2834,3523547,3579.0,3218820,,1571,186.0,264510.0,3020,3788057,3765,3483330,6599,7008381
196,2021-06-28 15:00:00,5037,3528584,6535.0,3225355,7.0,1578,547.0,265057.0,5584,3793641,7082,3490412,12126,7020507
197,2021-06-29 15:00:00,5143,3533727,6624.0,3231979,5.0,1583,535.0,265592.0,5678,3799319,7159,3497571,12307,7032814
198,2021-06-30 15:00:00,5750,3539477,7612.0,3239591,5.0,1588,617.0,266209.0,6367,3805686,8229,3505800,13984,7046798
199,2021-07-01 15:00:00,5530,3545007,7155.0,3246746,11.0,1599,522.0,266731.0,6052,3811738,7677,3513477,13218,7060016
200,2021-07-02 15:00:00,5424,3550431,7012.0,3253758,2.0,1601,537.0,267268.0,5961,3817699,7549,3521026,12975,7072991
201,2021-07-03 15:00:00,3356,3553787,4159.0,3257917,1.0,1602,273.0,267541.0,3629,3821328,4432,3525458,7789,7080780
202,2021-07-04 15:00:00,509,3554296,557.0,3258474,,1602,72.0,267613.0,581,3821909,629,3526087,1138,7081918
203,2021-07-05 15:00:00,3836,3558132,3999.0,3262473,3.0,1605,297.0,267910.0,4133,3826042,4296,3530383,8135,7090053
204,2021-07-06 15:00:00,4546,3562678,6421.0,3268894,3.0,1608,465.0,268375.0,5011,3831053,6886,3537269,11435,7101488
205,2021-07-07 15:00:00,4558,3567236,6606.0,3275500,,1608,500.0,268875.0,5058,3836111,7106,3544375,11664,7113152
206,2021-07-08 15:00:00,4919,3572155,6303.0,3281803,3.0,1611,575.0,269450.0,5494,3841605,6878,3551253,11800,7124952
207,2021-07-09 15:00:00,5471,3577626,6863.0,3288666,1.0,1612,585.0,270035.0,6056,3847661,7448,3558701,12920,7137872
208,2021-07-10 15:00:00,3592,3581218,4509.0,3293175,,1612,319.0,270354.0,3911,3851572,4828,3563529,8420,7146292
209,2021-07-11 15:00:00,2728,3583946,2623.0,3295798,,1612,233.0,270587.0,2961,3854533,2856,3566385,5584,7151876
210,2021-07-12 15:00:00,4514,3588460,5233.0,3301031,6.0,1618,388.0,270975.0,4902,3859435,5621,3572006,10141,7162017
211,2021-07-13 15:00:00,4729,3593189,4886.0,3305917,3.0,1621,368.0,271343.0,5097,3864532,5254,3577260,9986,7172003
212,2021-07-14 15:00:00,4731,3597920,5436.0,3311353,5.0,1626,430.0,271773.0,5161,3869693,5866,3583126,10602,7182605
213,2021-07-15 15:00:00,4993,3602913,5147.0,3316500,1.0,1627,371.0,272144.0,5364,3875057,5518,3588644,10512,7193117
214,2021-07-16 15:00:00,6360,3609273,6013.0,3322513,1.0,1628,409.0,272553.0,6769,3881826,6422,3595066,12783,7205900
215,2021-07-17 15:00:00,3497,3612770,3610.0,3326123,1.0,1629,319.0,272872.0,3816,3885642,3929,3598995,7427,7213327
216,2021-07-18 15:00:00,2359,3615129,2421.0,3328544,,1629,119.0,272991.0,2478,3888120,2540,3601535,4899,7218226
217,2021-07-19 15:00:00,5247,3620376,4727.0,3333271,2.0,1631,395.0,273386.0,5642,3893762,5122,3606657,10371,7228597
218,2021-07-20 15:00:00,5438,3625814,4853.0,3338124,1.0,1632,370.0,273756.0,5808,3899570,5223,3611880,10662,7239259
219,2021-07-21 15:00:00,5804,3631618,5088.0,3343212,4.0,1636,424.0,274180.0,6228,3905798,5512,3617392,11320,7250579
220,2021-07-22 15:00:00,6143,3637761,4754.0,3347966,2.0,1638,475.0,274655.0,6618,3912416,5229,3622621,11374,7261953
221,2021-07-23 15:00:00,6988,3644749,4996.0,3352962,1.0,1639,511.0,275166.0,7499,3919915,5507,3628128,12496,7274449
222,2021-07-24 15:00:00,4348,3649097,3289.0,3356251,,1639,273.0,275439.0,4621,3924536,3562,3631690,7910,7282359
223,2021-07-25 15:00:00,3352,3652449,1154.0,3357405,,1639,144.0,275583.0,3496,3928032,1298,3632988,4650,7287009
224,2021-07-26 15:00:00,6327,3658776,4026.0,3361431,2.0,1641,427.0,276010.0,6754,3934786,4453,3637441,10782,7297791
225,2021-07-27 15:00:00,6731,3665507,4397.0,3365828,,1641,477.0,276487.0,7208,3941994,4874,3642315,11605,7309396
226,2021-07-28 15:00:00,7243,3672750,4276.0,3370104,4.0,1645,484.0,276971.0,7727,3949721,4760,3647075,12007,7321403
227,2021-07-29 15:00:00,7220,3679970,4434.0,3374538,3.0,1648,442.0,277413.0,7662,3957383,4876,3651951,12099,7333502
228,2021-07-30 15:00:00,7960,3687930,4954.0,3379492,1.0,1649,550.0,277963.0,8510,3965893,5504,3657455,13465,7346967
229,2021-07-31 15:00:00,4904,3692834,3163.0,3382655,2.0,1651,285.0,278248.0,5189,3971082,3448,3660903,8354,7355321
230,2021-08-01 15:00:00,3993,3696827,2270.0,3384925,218.0,1869,178.0,278426.0,4171,3975253,2448,3663351,6659,7361980
231,2021-08-02 15:00:00,7437,3704264,3977.0,3388902,146.0,2015,364.0,278790.0,7801,3983054,4341,3667692,11924,7373904
232,2021-08-03 15:00:00,7425,3711689,4198.0,3393100,109.0,2124,526.0,279316.0,7951,3991005,4724,3672416,12258,7386162
233,2021-08-04 15:00:00,7610,3719299,4227.0,3397327,113.0,2237,566.0,279882.0,8176,3999181,4793,3677209,12516,7398678
234,2021-08-05 15:00:00,8109,3727408,4439.0,3401766,108.0,2345,555.0,280437.0,8664,4007845,4994,3682203,13211,7411889
235,2021-08-06 15:00:00,8504,3735912,4874.0,3406640,149.0,2494,468.0,280905.0,8972,4016817,5342,3687545,13995,7425884
236,2021-08-07 15:00:00,5410,3741322,2922.0,3409562,101.0,2595,277.0,281182.0,5687,4022504,3199,3690744,8710,7434594
237,2021-08-08 15:00:00,4060,3745382,2113.0,3411675,77.0,2672,160.0,281342.0,4220,4026724,2273,3693017,6410,7441004
238,2021-08-09 15:00:00,7106,3752488,4680.0,3416355,112.0,2784,390.0,281732.0,7496,4034220,5070,3698087,12288,7453292
239,2021-08-10 15:00:00,7307,3759795,4634.0,3420989,130.0,2914,355.0,282087.0,7662,4041882,4989,3703076,12426,7465718
240,2021-08-11 15:00:00,7275,3767070,4608.0,3425597,123.0,3037,461.0,282548.0,7736,4049618,5069,3708145,12467,7478185
241,2021-08-12 15:00:00,8810,3775880,4900.0,3430497,164.0,3201,472.0,283020.0,9282,4058900,5372,3713517,14346,7492531
242,2021-08-13 15:00:00,7329,3783209,5536.0,3436033,216.0,3417,418.0,283438.0,7747,4066647,5954,3719471,13499,7506030
243,2021-08-14 15:00:00,5019,3788228,3429.0,3439462,701.0,4118,302.0,283740.0,5321,4071968,3731,3723202,9451,7515481
244,2021-08-15 15:00:00,3390,3791618,2819.0,3442281,594.0,4712,175.0,283915.0,3565,4075533,2994,3726196,6978,7522459
245,2021-08-16 15:00:00,5614,3797232,5222.0,3447503,1286.0,5998,375.0,284290.0,5989,4081522,5597,3731793,12497,7534956
246,2021-08-17 15:00:00,6985,3804217,5532.0,3453035,1493.0,7491,399.0,284689.0,7384,4088906,5931,3737724,14409,7549365
247,2021-08-18 15:00:00,6517,3810734,5744.0,3458779,1708.0,9199,491.0,285180.0,7008,4095914,6235,3743959,14460,7563825
248,2021-08-19 15:00:00,6358,3817092,5734.0,3464513,1679.0,10878,428.0,285608.0,6786,4102700,6162,3750121,14199,7578024
249,2021-08-20 15:00:00,7005,3824097,6756.0,3471269,1787.0,12665,418.0,286026.0,7423,4110123,7174,3757295,15966,7593990
250,2021-08-21 15:00:00,4433,3828530,4038.0,3475307,918.0,13583,240.0,286266.0,4673,4114796,4278,3761573,9629,7603619
251,2021-08-22 15:00:00,3123,3831653,3254.0,3478561,834.0,14417,119.0,286385.0,3242,4118038,3373,3764946,7330,7610949
252,2021-08-23 15:00:00,6119,3837772,6287.0,3484848,1856.0,16273,298.0,286683.0,6417,4124455,6585,3771531,14560,7625509
253,2021-08-24 15:00:00,6704,3844476,6243.0,3491091,1779.0,18052,443.0,287126.0,7147,4131602,6686,3778217,15169,7640678
254,2021-08-25 15:00:00,6875,3851351,6421.0,3497512,1653.0,19705,457.0,287583.0,7332,4138934,6878,3785095,15406,7656084
255,2021-08-26 15:00:00,7104,3858455,6829.0,3504341,1786.0,21491,439.0,288022.0,7543,4146477,7268,3792363,16158,7672242
256,2021-08-27 15:00:00,6998,3865453,7279.0,3511620,2055.0,23546,333.0,288355.0,7331,4153808,7612,3799975,16665,7688907
257,2021-08-28 15:00:00,7008,3872461,6667.0,3518287,1039.0,24585,339.0,288694.0,7347,4161155,7006,3806981,15053,7703960
258,2021-08-29 15:00:00,3801,3876262,3769.0,3522056,706.0,25291,618.0,289312.0,4419,4165574,4387,3811368,8894,7712854
259,2021-08-30 15:00:00,6054,3882316,6328.0,3528384,1590.0,26881,978.0,290290.0,7032,4172606,7306,3818674,14950,7727804
260,2021-08-31 15:00:00,6062,3888378,6259.0,3534643,1718.0,28599,962.0,291252.0,7024,4179630,7221,3825895,15001,7742805
261,2021-09-01 15:00:00,5796,3894174,5965.0,3540608,1904.0,30503,935.0,292187.0,6731,4186361,6900,3832795,14600,7757405
262,2021-09-02 15:00:00,5624,3899798,6141.0,3546749,1906.0,32409,713.0,292900.0,6337,4192698,6854,3839649,14384,7771789
263,2021-09-03 15:00:00,6138,3905936,7123.0,3553872,1909.0,34318,984.0,293884.0,7122,4199820,8107,3847756,16154,7787943
264,2021-09-04 15:00:00,3799,3909735,4442.0,3558314,921.0,35239,890.0,294774.0,4689,4204509,5332,3853088,10052,7797995
265,2021-09-05 15:00:00,2999,3912734,2886.0,3561200,686.0,35925,120.0,294894.0,3119,4207628,3006,3856094,6691,7804686
266,2021-09-06 15:00:00,1076,3913810,1194.0,3562394,232.0,36157,76.0,294970.0,1152,4208780,1270,3857364,2578,7807264
267,2021-09-07 15:00:00,5464,3919274,7526.0,3569920,1471.0,37628,2318.0,297288.0,7782,4216562,9844,3867208,16779,7824043
268,2021-09-08 15:00:00,4797,3924071,5723.0,3575643,1608.0,39236,375.0,297663.0,5172,4221734,6098,3873306,12503,7836546
269,2021-09-09 15:00:00,5154,3929225,5603.0,3581246,2359.0,41595,343.0,298006.0,5497,4227231,5946,3879252,13459,7850005
270,2021-09-10 15:00:00,6627,3935852,6840.0,3588086,2560.0,44155,1738.0,299744.0,8365,4235596,8578,3887830,17765,7867770
271,2021-09-11 15:00:00,4251,3940103,4464.0,3592550,1036.0,45191,684.0,300428.0,4935,4240531,5148,3892978,10435,7878205
272,2021-09-12 15:00:00,3235,3943338,3318.0,3595868,715.0,45906,448.0,300876.0,3683,4244214,3766,3896744,7716,7885921
273,2021-09-13 15:00:00,4974,3948312,5226.0,3601094,1577.0,47483,361.0,301237.0,5335,4249549,5587,3902331,12138,7898059
274,2021-09-14 15:00:00,4842,3953154,5618.0,3606712,1655.0,49138,457.0,301694.0,5299,4254848,6075,3908406,12572,7910631
275,2021-09-15 15:00:00,5142,3958296,6075.0,3612787,1551.0,50689,410.0,302104.0,5552,4260400,6485,3914891,13178,7923809
276,2021-09-16 15:00:00,4875,3963171,5989.0,3618776,1661.0,52350,356.0,302460.0,5231,4265631,6345,3921236,12881,7936690
277,2021-09-17 15:00:00,5372,3968543,6762.0,3625538,1993.0,54343,362.0,302822.0,5734,4271365,7124,3928360,14489,7951179
278,2021-09-18 15:00:00,3883,3972426,4724.0,3630262,955.0,55298,197.0,303019.0,4080,4275445,4921,3933281,9759,7960938
279,2021-09-19 15:00:00,2782,3975208,3249.0,3633511,714.0,56012,85.0,303104.0,2867,4278312,3334,3936615,6830,7967768
280,2021-09-20 15:00:00,3791,3978999,4837.0,3638348,1821.0,57833,436.0,303540.0,4227,4282539,5273,3941888,10885,7978653
281,2021-09-21 15:00:00,4053,3983052,5161.0,3643509,1923.0,59756,350.0,303890.0,4403,4286942,5511,3947399,11487,7990140
282,2021-09-22 15:00:00,4282,3987334,4962.0,3648471,1787.0,61543,468.0,304358.0,4750,4291692,5430,3952829,11499,8001639
283,2021-09-23 15:00:00,4243,3991577,4832.0,3653303,2257.0,63800,501.0,304859.0,4744,4296436,5333,3958162,11833,8013472
284,2021-09-24 15:00:00,5164,3996741,5780.0,3659083,4924.0,68724,435.0,305294.0,5599,4302035,6215,3964377,16303,8029775
285,2021-09-25 15:00:00,3670,4000411,3731.0,3662814,4992.0,73716,385.0,305679.0,4055,4306090,4116,3968493,12778,8042553
286,2021-09-26 15:00:00,2355,4002766,2737.0,3665551,3138.0,76854,446.0,306125.0,2801,4308891,3183,3971676,8676,8051229
287,2021-09-27 15:00:00,4531,4007297,2797.0,3668348,8998.0,85852,523.0,306648.0,5054,4313945,3320,3974996,16849,8068078
288,2021-09-28 15:00:00,4439,4011736,4617.0,3672965,9836.0,95688,216.0,306864.0,4655,4318600,4833,3979829,19108,8087186
289,2021-09-29 15:00:00,4739,4016475,4677.0,3677642,10026.0,105714,921.0,307785.0,5660,4324260,5598,3985427,20363,8107549
290,2021-09-30 15:00:00,4931,4021406,4710.0,3682352,10111.0,115825,807.0,308592.0,5738,4329998,5517,3990944,20559,8128108
291,2021-10-01 15:00:00,5585,4026991,5512.0,3687864,12361.0,128186,804.0,309396.0,6389,4336387,6316,3997260,24262,8152370
292,2021-10-02 15:00:00,2963,4029954,2980.0,3690844,5877.0,134063,193.0,309589.0,3156,4339543,3173,4000433,12013,8164383
293,2021-10-03 15:00:00,2085,4032039,2419.0,3693263,3539.0,137602,91.0,309680.0,2176,4341719,2510,4002943,8134,8172517
294,2021-10-04 15:00:00,4043,4036082,3603.0,3696866,10008.0,147610,260.0,309940.0,4303,4346022,3863,4006806,17914,8190431
295,2021-10-05 15:00:00,3968,4040050,3799.0,3700665,10404.0,158014,223.0,310163.0,4191,4350213,4022,4010828,18394,8208825
296,2021-10-06 15:00:00,4086,4044136,3711.0,3704376,9168.0,167182,270.0,310433.0,4356,4354569,3981,4014809,17235,8226060
297,2021-10-07 15:00:00,4260,4048396,3756.0,3708132,10154.0,177336,345.0,310778.0,4605,4359174,4101,4018910,18515,8244575
298,2021-10-08 15:00:00,4814,4053210,4438.0,3712570,11770.0,189106,297.0,311075.0,5111,4364285,4735,4023645,21319,8265894
299,2021-10-09 15:00:00,2733,4055943,2759.0,3715329,4398.0,193504,276.0,311351.0,3009,4367294,3035,4026680,10166,8276060
300,2021-10-10 15:00:00,1866,4057809,1907.0,3717236,3656.0,197160,63.0,311414.0,1929,4369223,1970,4028650,7492,8283552
301,2021-10-11 15:00:00,4229,4062038,3410.0,3720646,9417.0,206577,261.0,311675.0,4490,4373713,3671,4032321,17317,8300869
302,2021-10-12 15:00:00,3648,4065686,3638.0,3724284,9976.0,216553,285.0,311960.0,3933,4377646,3923,4036244,17547,8318416
303,2021-10-13 15:00:00,4047,4069733,3630.0,3727914,9248.0,225801,364.0,312324.0,4411,4382057,3994,4040238,17289,8335705
304,2021-10-14 15:00:00,5183,4074916,5583.0,3733497,9697.0,235498,439.0,312763.0,5622,4387679,6022,4046260,20902,8356607
305,2021-10-15 15:00:00,4800,4079716,4758.0,3738255,10929.0,246427,355.0,313118.0,5155,4392834,5113,4051373,20842,8377449
306,2021-10-16 15:00:00,2529,4082245,2594.0,3740849,4783.0,251210,298.0,313416.0,2827,4395661,2892,4054265,10204,8387653
307,2021-10-17 15:00:00,1825,4084070,1804.0,3742653,2849.0,254059,59.0,313475.0,1884,4397545,1863,4056128,6537,8394190
308,2021-10-18 15:00:00,4301,4088371,3662.0,3746315,9451.0,263510,287.0,313762.0,4588,4402133,3949,4060077,17701,8411891
309,2021-10-19 15:00:00,4312,4092683,4125.0,3750440,9814.0,273324,233.0,313995.0,4545,4406678,4358,4064435,18484,8430375
310,2021-10-20 15:00:00,3589,4096272,3539.0,3753979,9303.0,282627,269.0,314264.0,3858,4410536,3808,4068243,16700,8447075
311,2021-10-21 15:00:00,3345,4099617,3359.0,3757338,10208.0,292835,294.0,314558.0,3639,4414175,3653,4071896,17206,8464281
312,2021-10-22 15:00:00,4642,4104259,4106.0,3761444,19173.0,312008,484.0,315042.0,5126,4419301,4590,4076486,28405,8492686
313,2021-10-23 15:00:00,2878,4107137,2169.0,3763613,11292.0,323300,329.0,315371.0,3207,4422508,2498,4078984,16668,8509354
314,2021-10-24 15:00:00,2035,4109172,1586.0,3765199,7368.0,330668,83.0,315454.0,2118,4424626,1669,4080653,11072,8520426
315,2021-10-25 15:00:00,4513,4113685,3119.0,3768318,23675.0,354343,325.0,315779.0,4838,4429464,3444,4084097,31632,8552058
316,2021-10-26 15:00:00,4451,4118136,3103.0,3771421,25897.0,380240,313.0,316092.0,4764,4434228,3416,4087513,33764,8585822
317,2021-10-27 15:00:00,4668,4122804,3393.0,3774814,25941.0,406181,428.0,316520.0,5096,4439324,3821,4091334,34430,8620252
318,2021-10-28 15:00:00,4476,4127280,3389.0,3778203,26875.0,433056,500.0,317020.0,4976,4444300,3889,4095223,35240,8655492
319,2021-10-29 15:00:00,4923,4132203,3971.0,3782174,26780.0,459836,393.0,317413.0,5316,4449616,4364,4099587,36067,8691559
320,2021-10-30 15:00:00,2575,4134778,1867.0,3784041,13860.0,473696,307.0,317720.0,2882,4452498,2174,4101761,18609,8710168
321,2021-10-31 15:00:00,1889,4136667,1526.0,3785567,7927.0,481623,93.0,317813.0,1982,4454480,1619,4103380,11435,8721603
322,2021-11-01 15:00:00,4723,4141390,3504.0,3789071,26506.0,508129,352.0,318165.0,5075,4459555,3856,4107236,35085,8756688
323,2021-11-02 15:00:00,4177,4145567,2970.0,3792041,26451.0,534580,410.0,318575.0,4587,4464142,3380,4110616,34008,8790696
324,2021-11-03 15:00:00,4620,4150187,3099.0,3795140,26567.0,561147,461.0,319036.0,5081,4469223,3560,4114176,34747,8825443
325,2021-11-04 15:00:00,6267,4156454,3383.0,3798523,27660.0,588807,530.0,319566.0,6797,4476020,3913,4118089,37840,8863283
326,2021-11-05 15:00:00,8187,4164641,3813.0,3802336,28597.0,617404,412.0,319978.0,8599,4484619,4225,4122314,41009,8904292
327,2021-11-06 15:00:00,10154,4174795,1987.0,3804323,13171.0,630575,309.0,320287.0,10463,4495082,2296,4124610,25621,8929913
328,2021-11-07 15:00:00,7870,4182665,1470.0,3805793,7508.0,638083,111.0,320398.0,7981,4503063,1581,4126191,16959,8946872
329,2021-11-08 15:00:00,11356,4194021,3123.0,3808916,20065.0,658148,379.0,320777.0,11735,4514798,3502,4129693,34923,8981795
330,2021-11-09 15:00:00,11776,4205797,2655.0,3811571,23507.0,681655,267.0,321044.0,12043,4526841,2922,4132615,38205,9020000
331,2021-11-10 15:00:00,12648,4218445,2827.0,3814398,24156.0,705811,354.0,321398.0,13002,4539843,3181,4135796,39985,9059985
332,2021-11-11 15:00:00,11423,4229868,2381.0,3816779,22466.0,728277,278.0,321676.0,11701,4551544,2659,4138455,36548,9096533
333,2021-11-12 15:00:00,12363,4242231,3395.0,3820174,26611.0,754888,545.0,322221.0,12908,4564452,3940,4142395,42914,9139447
334,2021-11-13 15:00:00,9975,4252206,1607.0,3821781,12638.0,767526,343.0,322564.0,10318,4574770,1950,4144345,24563,9164010
335,2021-11-14 15:00:00,4203,4256409,1119.0,3822900,7448.0,774974,121.0,322685.0,4324,4579094,1240,4145585,12891,9176901
336,2021-11-15 15:00:00,8606,4265015,2548.0,3825448,21274.0,796248,210.0,322895.0,8816,4587910,2758,4148343,32638,9209539
337,2021-11-16 15:00:00,9270,4274285,2544.0,3827992,23544.0,819792,259.0,323154.0,9529,4597439,2803,4151146,35617,9245156
338,2021-11-17 15:00:00,9391,4283676,2920.0,3830912,23178.0,842970,313.0,323467.0,9704,4607143,3233,4154379,35802,9280958
339,2021-11-18 15:00:00,9277,4292953,2654.0,3833566,23217.0,866187,486.0,323953.0,9763,4616906,3140,4157519,35634,9316592
340,2021-11-19 15:00:00,9835,4302788,2978.0,3836544,28279.0,894466,397.0,324350.0,10232,4627138,3375,4160894,41489,9358081
341,2021-11-20 15:00:00,10644,4313432,1631.0,3838175,14761.0,909227,454.0,324804.0,11098,4638236,2085,4162979,27490,9385571
342,2021-11-21 15:00:00,4368,4317800,1220.0,3839395,10158.0,919385,99.0,324903.0,4467,4642703,1319,4164298,15845,9401416
343,2021-11-22 15:00:00,9766,4327566,2541.0,3841936,25313.0,944698,292.0,325195.0,10058,4652761,2833,4167131,37912,9439328
344,2021-11-23 15:00:00,9185,4336751,2408.0,3844344,25574.0,970272,320.0,325515.0,9505,4662266,2728,4169859,37487,9476815
345,2021-11-24 15:00:00,8152,4344903,2473.0,3846817,20717.0,990989,220.0,325735.0,8372,4670638,2693,4172552,31562,9508377
346,2021-11-25 15:00:00,234,4345137,92.0,3846909,624.0,991613,10.0,325745.0,244,4670882,102,4172654,960,9509337
347,2021-11-26 15:00:00,5601,4350738,4007.0,3850916,16256.0,1007869,154.0,325899.0,5755,4676637,4161,4176815,26018,9535355
348,2021-11-27 15:00:00,3701,4354439,5501.0,3856417,11420.0,1019289,134.0,326033.0,3835,4680472,5635,4182450,20756,9556111
349,2021-11-28 15:00:00,2358,4356797,6437.0,3862854,7817.0,1027106,77.0,326110.0,2435,4682907,6514,4188964,16689,9572800
350,2021-11-29 15:00:00,6303,4363100,9443.0,3872297,19489.0,1046595,383.0,326493.0,6686,4689593,9826,4198790,35618,9608418
351,2021-11-30 15:00:00,6216,4369316,9474.0,3881771,23554.0,1070149,264.0,326757.0,6480,4696073,9738,4208528,39508,9647926
352,2021-12-01 15:00:00,7304,4376620,9952.0,3891723,26678.0,1096827,313.0,327070.0,7617,4703690,10265,4218793,44247,9692173
353,2021-12-02 15:00:00,6898,4383518,8927.0,3900650,27971.0,1124798,465.0,327535.0,7363,4711053,9392,4228185,44261,9736434
354,2021-12-03 15:00:00,7570,4391088,9479.0,3910129,31615.0,1156413,255.0,327790.0,7825,4718878,9734,4237919,48919,9785353
355,2021-12-04 15:00:00,5847,4396935,10270.0,3920399,17475.0,1173888,464.0,328254.0,6311,4725189,10734,4248653,34056,9819409
356,2021-12-05 15:00:00,3373,4400308,3596.0,3923995,10101.0,1183989,79.0,328333.0,3452,4728641,3675,4252328,17149,9836558
357,2021-12-06 15:00:00,6746,4407054,7171.0,3931166,25334.0,1209323,292.0,328625.0,7038,4735679,7463,4259791,39543,9876101
358,2021-12-07 15:00:00,6390,4413444,7134.0,3938300,26263.0,1235586,259.0,328884.0,6649,4742328,7393,4267184,40046,9916147
359,2021-12-08 15:00:00,6895,4420339,7516.0,3945816,25492.0,1261078,316.0,329200.0,7211,4749539,7832,4275016,40219,9956366
360,2021-12-09 15:00:00,6497,4426836,7150.0,3952966,26233.0,1287311,407.0,329607.0,6904,4756443,7557,4282573,40287,9996653
361,2021-12-10 15:00:00,7185,4434021,7408.0,3960374,27853.0,1315164,267.0,329874.0,7452,4763895,7675,4290248,42713,10039366
362,2021-12-11 15:00:00,4384,4438405,7776.0,3968150,15045.0,1330209,331.0,330205.0,4715,4768610,8107,4298355,27536,10066902
363,2021-12-12 15:00:00,3960,4442365,2823.0,3970973,8255.0,1338464,69.0,330274.0,4029,4772639,2892,4301247,15107,10082009
364,2021-12-13 15:00:00,5676,4448041,5861.0,3976834,23012.0,1361476,242.0,330516.0,5918,4778557,6103,4307350,34791,10116800
365,2021-12-14 15:00:00,6365,4454406,6029.0,3982863,24450.0,1385926,223.0,330739.0,6588,4785145,6252,4313602,37067,10153867
366,2021-12-15 15:00:00,7118,4461524,5817.0,3988680,22946.0,1408872,257.0,330996.0,7375,4792520,6074,4319676,36138,10190005
367,2021-12-16 15:00:00,7807,4469331,2859.0,3991539,26281.0,1435153,421.0,331417.0,8228,4800748,3280,4322956,37368,10227373
368,2021-12-17 15:00:00,7733,4477064,4217.0,3995756,27560.0,1462713,196.0,331613.0,7929,4808677,4413,4327369,39706,10267079
369,2021-12-18 15:00:00,5820,4482884,3247.0,3999003,16189.0,1478902,298.0,331911.0,6118,4814795,3545,4330914,25554,10292633
370,2021-12-19 15:00:00,3305,4486189,1349.0,4000352,9984.0,1488886,38.0,331949.0,3343,4818138,1387,4332301,14676,10307309
371,2021-12-20 15:00:00,7954,4494143,3780.0,4004132,27650.0,1516536,169.0,332118.0,8123,4826261,3949,4336250,39553,10346862
372,2021-12-21 15:00:00,8918,4503061,4244.0,4008376,28313.0,1544849,188.0,332306.0,9106,4835367,4432,4340682,41663,10388525
373,2021-12-22 15:00:00,8611,4511672,3986.0,4012362,28348.0,1573197,190.0,332496.0,8801,4844168,4176,4344858,41135,10429660
374,2021-12-23 15:00:00,8309,4519981,3632.0,4015994,23873.0,1597070,359.0,332855.0,8668,4852836,3991,4348849,36173,10465833
375,2021-12-24 15:00:00,1603,4521584,1028.0,4017022,4852.0,1601922,39.0,332894.0,1642,4854478,1067,4349916,7522,10473355
376,2021-12-25 15:00:00,50,4521634,38.0,4017060,286.0,1602208,1.0,332895.0,51,4854529,39,4349955,375,10473730
377,2021-12-26 15:00:00,2467,4524101,1761.0,4018821,7200.0,1609408,43.0,332938.0,2510,4857039,1804,4351759,11471,10485201
378,2021-12-27 15:00:00,7168,4531269,4140.0,4022961,21573.0,1630981,294.0,333232.0,7462,4864501,4434,4356193,33175,10518376
379,2021-12-28 15:00:00,7901,4539170,3919.0,4026880,24408.0,1655389,181.0,333413.0,8082,4872583,4100,4360293,36409,10554785
380,2021-12-29 15:00:00,8236,4547406,4098.0,4030978,23184.0,1678573,155.0,333568.0,8391,4880974,4253,4364546,35673,10590458
381,2021-12-30 15:00:00,7402,4554808,3867.0,4034845,21669.0,1700242,287.0,333855.0,7689,4888663,4154,4368700,33225,10623683
382,2021-12-31 15:00:00,2569,4557377,1573.0,4036418,7373.0,1707615,92.0,333947.0,2661,4891324,1665,4370365,11607,10635290
383,2022-01-01 15:00:00,762,4558139,366.0,4036784,1934.0,1709549,34.0,333981.0,796,4892120,400,4370765,3096,10638386
384,2022-01-02 15:00:00,2195,4560334,1655.0,4038439,5568.0,1715117,48.0,334029.0,2243,4894363,1703,4372468,9466,10647852
385,2022-01-03 15:00:00,3367,4563701,2112.0,4040551,10844.0,1725961,227.0,334256.0,3594,4897957,2339,4374807,16550,10664402
386,2022-01-04 15:00:00,5835,4569536,3572.0,4044123,16128.0,1742089,165.0,334421.0,6000,4903957,3737,4378544,25700,10690102
387,2022-01-05 15:00:00,6857,4576393,4810.0,4048933,18304.0,1760393,177.0,334598.0,7034,4910991,4987,4383531,30148,10720250
388,2022-01-06 15:00:00,6768,4583161,4903.0,4053836,22422.0,1782815,265.0,334863.0,7033,4918024,5168,4388699,34358,10754608
389,2022-01-07 15:00:00,5963,4589124,3886.0,4057722,19685.0,1802500,160.0,335023.0,6123,4924147,4046,4392745,29694,10784302
390,2022-01-08 15:00:00,4735,4593859,4003.0,4061725,13346.0,1815846,77.0,335100.0,4812,4928959,4080,4396825,22161,10806463
391,2022-01-09 15:00:00,2728,4596587,2040.0,4063765,7600.0,1823446,154.0,335254.0,2882,4931841,2194,4399019,12522,10818985
392,2022-01-10 15:00:00,6290,4602877,3929.0,4067694,18837.0,1842283,159.0,335413.0,6449,4938290,4088,4403107,29215,10848200
393,2022-01-11 15:00:00,6511,4609388,4340.0,4072034,18131.0,1860414,143.0,335556.0,6654,4944944,4483,4407590,29125,10877325
394,2022-01-12 15:00:00,6829,4616217,4533.0,4076567,18726.0,1879140,223.0,335779.0,7052,4951996,4756,4412346,30311,10907636
395,2022-01-13 15:00:00,6689,4622906,4453.0,4081020,17412.0,1896552,149.0,335928.0,6838,4958834,4602,4416948,28703,10936339
396,2022-01-14 15:00:00,7244,4630150,3335.0,4084355,22103.0,1918655,256.0,336184.0,7500,4966334,3591,4420539,32938,10969277
397,2022-01-15 15:00:00,4275,4634425,1710.0,4086065,11646.0,1930301,71.0,336255.0,4346,4970680,1781,4422320,17702,10986979
398,2022-01-16 15:00:00,2186,4636611,1335.0,4087400,6251.0,1936552,116.0,336371.0,2302,4972982,1451,4423771,9888,10996867
399,2022-01-17 15:00:00,3595,4640206,2432.0,4089832,10236.0,1946788,74.0,336445.0,3669,4976651,2506,4426277,16337,11013204
400,2022-01-18 15:00:00,5269,4645475,4301.0,4094133,13353.0,1960141,103.0,336548.0,5372,4982023,4404,4430681,23026,11036230
401,2022-01-19 15:00:00,5331,4650806,4598.0,4098731,13348.0,1973489,97.0,336645.0,5428,4987451,4695,4435376,23374,11059604
402,2022-01-20 15:00:00,4540,4655346,3689.0,4102420,11941.0,1985430,174.0,336819.0,4714,4992165,3863,4439239,20344,11079948
403,2022-01-21 15:00:00,5594,4660940,2979.0,4105399,15077.0,2000507,124.0,336943.0,5718,4997883,3103,4442342,23774,11103722
404,2022-01-22 15:00:00,3449,4664389,1772.0,4107171,9037.0,2009544,134.0,337077.0,3583,5001466,1906,4444248,14392,11118114
405,2022-01-23 15:00:00,2017,4666406,1514.0,4108685,5791.0,2015335,31.0,337108.0,2048,5003514,1545,4445793,9353,11127467
406,2022-01-24 15:00:00,4116,4670522,2810.0,4111495,11493.0,2026828,91.0,337199.0,4207,5007721,2901,4448694,18510,11145977
407,2022-01-25 15:00:00,3820,4674342,3409.0,4114904,9359.0,2036187,93.0,337292.0,3913,5011634,3502,4452196,16681,11162658
408,2022-01-26 15:00:00,3917,4678259,3780.0,4118684,9243.0,2045430,96.0,337388.0,4013,5015647,3876,4456072,17036,11179694
409,2022-01-27 15:00:00,3785,4682044,3994.0,4122678,10369.0,2055799,189.0,337577.0,3974,5019621,4183,4460255,18337,11198031
410,2022-01-28 15:00:00,3859,4685903,3344.0,4126022,11380.0,2067179,76.0,337653.0,3935,5023556,3420,4463675,18659,11216690
411,2022-01-29 15:00:00,2291,4688194,2331.0,4128353,5952.0,2073131,116.0,337769.0,2407,5025963,2447,4466122,10690,11227380
412,2022-01-30 15:00:00,1530,4689724,1668.0,4130021,3802.0,2076933,16.0,337785.0,1546,5027509,1684,4467806,7016,11234396
413,2022-01-31 15:00:00,2998,4692722,3295.0,4133316,7717.0,2084650,58.0,337843.0,3056,5030565,3353,4471159,14068,11248464
414,2022-02-01 15:00:00,2649,4695371,3502.0,4136818,6895.0,2091545,75.0,337918.0,2724,5033289,3577,4474736,13121,11261585
415,2022-02-02 15:00:00,2831,4698202,3827.0,4140645,6743.0,2098288,79.0,337997.0,2910,5036199,3906,4478642,13480,11275065
416,2022-02-03 15:00:00,2758,4700960,3763.0,4144408,7014.0,2105302,43.0,338040.0,2801,5039000,3806,4482448,13578,11288643
417,2022-02-04 15:00:00,2761,4703721,4460.0,4148868,7966.0,2113268,128.0,338168.0,2889,5041889,4588,4487036,15315,11303958
418,2022-02-05 15:00:00,1889,4705610,2911.0,4151779,5082.0,2118350,112.0,338280.0,2001,5043890,3023,4490059,9994,11313952
419,2022-02-06 15:00:00,1071,4706681,1356.0,4153135,2490.0,2120840,26.0,338306.0,1097,5044987,1382,4491441,4943,11318895
420,2022-02-07 15:00:00,2073,4708754,2745.0,4155880,5325.0,2126165,51.0,338357.0,2124,5047111,2796,4494237,10194,11329089
421,2022-02-08 15:00:00,2084,4710838,3152.0,4159032,5317.0,2131482,61.0,338418.0,2145,5049256,3213,4497450,10614,11339703
422,2022-02-09 15:00:00,2206,4713044,3395.0,4162427,5973.0,2137455,82.0,338500.0,2288,5051544,3477,4500927,11656,11351359
423,2022-02-10 15:00:00,2102,4715146,2945.0,4165372,5917.0,2143372,55.0,338555.0,2157,5053701,3000,4503927,11019,11362378
424,2022-02-11 15:00:00,2508,4717654,3589.0,4168961,7733.0,2151105,127.0,338682.0,2635,5056336,3716,4507643,13957,11376335
425,2022-02-12 15:00:00,1691,4719345,2366.0,4171327,4610.0,2155715,97.0,338779.0,1788,5058124,2463,4510106,8764,11385099
426,2022-02-13 15:00:00,733,4720078,1103.0,4172430,1845.0,2157560,17.0,338796.0,750,5058874,1120,4511226,3698,11388797
427,2022-02-14 15:00:00,1507,4721585,2271.0,4174701,4088.0,2161648,89.0,338885.0,1596,5060470,2360,4513586,7955,11396752
428,2022-02-15 15:00:00,1945,4723530,2515.0,4177216,4084.0,2165732,52.0,338937.0,1997,5062467,2567,4516153,8596,11405348
429,2022-02-16 15:00:00,1738,4725268,2613.0,4179829,4180.0,2169912,57.0,338994.0,1795,5064262,2670,4518823,8588,11413936
430,2022-02-17 15:00:00,16904,4742172,13151.0,4192980,3991.0,2173903,500.0,339494.0,17404,5081666,13651,4532474,34546,11448482
431,2022-02-18 15:00:00,2094,4744266,2757.0,4195737,5068.0,2178971,58.0,339552.0,2152,5083818,2815,4535289,9977,11458459
432,2022-02-19 15:00:00,1260,4745526,1785.0,4197522,3189.0,2182160,45.0,339597.0,1305,5085123,1830,4537119,6279,11464738
433,2022-02-20 15:00:00,737,4746263,912.0,4198434,1831.0,2183991,19.0,339616.0,756,5085879,931,4538050,3499,11468237
434,2022-02-21 15:00:00,1355,4747618,1853.0,4200287,3186.0,2187177,42.0,339658.0,1397,5087276,1895,4539945,6436,11474673
435,2022-02-22 15:00:00,1517,4749135,2017.0,4202304,3284.0,2190461,40.0,339698.0,1557,5088833,2057,4542002,6858,11481531
436,2022-02-23 15:00:00,1648,4750783,2018.0,4204322,3417.0,2193878,43.0,339741.0,1691,5090524,2061,4544063,7126,11488657
437,2022-02-24 15:00:00,1598,4752381,1805.0,4206127,3170.0,2197048,42.0,339783.0,1640,5092164,1847,4545910,6615,11495272
438,2022-02-25 15:00:00,1768,4754149,1990.0,4208117,4400.0,2201448,79.0,339862.0,1847,5094011,2069,4547979,8237,11503509
439,2022-02-26 15:00:00,1241,4755390,1316.0,4209433,2871.0,2204319,51.0,339913.0,1292,5095303,1367,4549346,5479,11508988
440,2022-02-27 15:00:00,608,4755998,578.0,4210011,1457.0,2205776,20.0,339933.0,628,5095931,598,4549944,2663,11511651
441,2022-02-28 15:00:00,1358,4757356,1472.0,4211483,3289.0,2209065,41.0,339974.0,1399,5097330,1513,4551457,6160,11517811
442,2022-03-01 15:00:00,1422,4758778,1458.0,4212941,3122.0,2212187,33.0,340007.0,1455,5098785,1491,4552948,6035,11523846
443,2022-03-02 15:00:00,1251,4760029,1412.0,4214353,3242.0,2215429,74.0,340081.0,1325,5100110,1486,4554434,5979,11529825
444,2022-03-03 15:00:00,1340,4761369,1376.0,4215729,2877.0,2218306,42.0,340123.0,1382,5101492,1418,4555852,5635,11535460
445,2022-03-04 15:00:00,1541,4762910,1678.0,4217407,3926.0,2222232,54.0,340177.0,1595,5103087,1732,4557584,7199,11542659
446,2022-03-05 15:00:00,850,4763760,984.0,4218391,2108.0,2224340,29.0,340206.0,879,5103966,1013,4558597,3971,11546630
447,2022-03-06 15:00:00,480,4764240,526.0,4218917,1054.0,2225394,14.0,340220.0,494,5104460,540,4559137,2074,11548704
448,2022-03-07 15:00:00,974,4765214,930.0,4219847,2430.0,2227824,30.0,340250.0,1004,5105464,960,4560097,4364,11553068
449,2022-03-08 15:00:00,1142,4766356,1090.0,4220937,2619.0,2230443,34.0,340284.0,1176,5106640,1124,4561221,4885,11557953
450,2022-03-09 15:00:00,1007,4767363,1104.0,4222041,2370.0,2232813,47.0,340331.0,1054,5107694,1151,4562372,4528,11562481
451,2022-03-10 15:00:00,1005,4768368,1070.0,4223111,2306.0,2235119,23.0,340354.0,1028,5108722,1093,4563465,4404,11566885
452,2022-03-11 15:00:00,1198,4769566,1487.0,4224598,3037.0,2238156,52.0,340406.0,1250,5109972,1539,4565004,5774,11572659
453,2022-03-12 15:00:00,484,4770050,621.0,4225219,1170.0,2239326,14.0,340420.0,498,5110470,635,4565639,2289,11574948
454,2022-03-13 15:00:00,432,4770482,504.0,4225723,868.0,2240194,12.0,340432.0,444,5110914,516,4566155,1816,11576764
455,2022-03-14 15:00:00,859,4771341,766.0,4226489,1785.0,2241979,27.0,340459.0,886,5111800,793,4566948,3437,11580201
456,2022-03-15 15:00:00,898,4772239,964.0,4227453,2003.0,2243982,18.0,340477.0,916,5112716,982,4567930,3883,11584084
457,2022-03-16 15:00:00,954,4773193,1021.0,4228474,2067.0,2246049,35.0,340512.0,989,5113705,1056,4568986,4077,11588161
458,2022-03-17 15:00:00,850,4774043,938.0,4229412,1953.0,2248002,32.0,340544.0,882,5114587,970,4569956,3773,11591934
459,2022-03-18 15:00:00,1137,4775180,1183.0,4230595,2622.0,2250624,40.0,340584.0,1177,5115764,1223,4571179,4982,11596916
460,2022-03-19 15:00:00,626,4775806,708.0,4231303,1488.0,2252112,29.0,340613.0,655,5116419,737,4571916,2851,11599767
461,2022-03-20 15:00:00,381,4776187,384.0,4231687,812.0,2252924,11.0,340624.0,392,5116811,395,4572311,1588,11601355
462,2022-03-21 15:00:00,789,4776976,769.0,4232456,1941.0,2254865,25.0,340649.0,814,5117625,794,4573105,3524,11604879
463,2022-03-22 15:00:00,843,4777819,986.0,4233442,2180.0,2257045,19.0,340668.0,862,5118487,1005,4574110,4028,11608907
464,2022-03-23 15:00:00,854,4778673,908.0,4234350,2248.0,2259293,27.0,340695.0,881,5119368,935,4575045,4037,11612944
465,2022-03-24 15:00:00,821,4779494,988.0,4235338,1989.0,2261282,35.0,340730.0,856,5120224,1023,4576068,3833,11616777
466,2022-03-25 15:00:00,877,4780371,1033.0,4236371,2558.0,2263840,40.0,340770.0,917,5121141,1073,4577141,4508,11621285
467,2022-03-26 15:00:00,575,4780946,569.0,4236940,1612.0,2265452,23.0,340793.0,598,5121739,592,4577733,2779,11624064
468,2022-03-27 15:00:00,273,4781219,324.0,4237264,794.0,2266246,24.0,340817.0,297,5122036,348,4578081,1415,11625479
469,2022-03-28 15:00:00,738,4781957,698.0,4237962,1757.0,2268003,26.0,340843.0,764,5122800,724,4578805,3219,11628698
470,2022-03-29 15:00:00,865,4782822,792.0,4238754,1810.0,2269813,27.0,340870.0,892,5123692,819,4579624,3494,11632192
471,2022-03-30 15:00:00,909,4783731,994.0,4239748,2262.0,2272075,23.0,340893.0,932,5124624,1017,4580641,4188,11636380
472,2022-03-31 15:00:00,1039,4784770,1223.0,4240971,2453.0,2274528,29.0,340922.0,1068,5125692,1252,4581893,4744,11641124
473,2022-04-01 15:00:00,1136,4785906,1432.0,4242403,2938.0,2277466,48.0,340970.0,1184,5126876,1480,4583373,5554,11646678
474,2022-04-02 15:00:00,635,4786541,735.0,4243138,1625.0,2279091,17.0,340987.0,652,5127528,752,4584125,3012,11649690
475,2022-04-03 15:00:00,410,4786951,508.0,4243646,938.0,2280029,21.0,341008.0,431,5127959,529,4584654,1877,11651567
476,2022-04-04 15:00:00,905,4787856,1035.0,4244681,2201.0,2282230,30.0,341038.0,935,5128894,1065,4585719,4171,11655738
477,2022-04-05 15:00:00,862,4788718,986.0,4245667,2092.0,2284322,18.0,341056.0,880,5129774,1004,4586723,3958,11659696
478,2022-04-06 15:00:00,914,4789632,1109.0,4246776,2229.0,2286551,23.0,341079.0,937,5130711,1132,4587855,4275,11663971
479,2022-04-07 15:00:00,973,4790605,1060.0,4247836,2178.0,2288729,10.0,341089.0,983,5131694,1070,4588925,4221,11668192
480,2022-04-08 15:00:00,1028,4791633,1260.0,4249096,2563.0,2291292,25.0,341114.0,1053,5132747,1285,4590210,4876,11673068
481,2022-04-09 15:00:00,560,4792193,690.0,4249786,1292.0,2292584,10.0,341124.0,570,5133317,700,4590910,2552,11675620
482,2022-04-10 15:00:00,359,4792552,397.0,4250183,895.0,2293479,14.0,341138.0,373,5133690,411,4591321,1665,11677285
483,2022-04-11 15:00:00,913,4793465,988.0,4251171,2064.0,2295543,27.0,341165.0,940,5134630,1015,4592336,3992,11681277
484,2022-04-12 15:00:00,1000,4794465,1151.0,4252322,2472.0,2298015,24.0,341189.0,1024,5135654,1175,4593511,4647,11685924
485,2022-04-13 15:00:00,878,4795343,1029.0,4253351,2440.0,2300455,24.0,341213.0,902,5136556,1053,4594564,4371,11690295
486,2022-04-14 15:00:00,968,4796311,1001.0,4254352,2382.0,2302837,30.0,341243.0,998,5137554,1031,4595595,4381,11694676
487,2022-04-15 15:00:00,924,4797235,1033.0,4255385,2405.0,2305242,27.0,341270.0,951,5138505,1060,4596655,4389,11699065
488,2022-04-16 15:00:00,490,4797725,566.0,4255951,1347.0,2306589,26.0,341296.0,516,5139021,592,4597247,2429,11701494
489,2022-04-17 15:00:00,121,4797846,146.0,4256097,272.0,2306861,4.0,341300.0,125,5139146,150,4597397,543,11702037
490,2022-04-18 15:00:00,794,4798640,925.0,4257022,1982.0,2308843,26.0,341326.0,820,5139966,951,4598348,3727,11705764
491,2022-04-19 15:00:00,851,4799491,903.0,4257925,2105.0,2310948,17.0,341343.0,868,5140834,920,4599268,3876,11709640
492,2022-04-20 15:00:00,745,4800236,840.0,4258765,1897.0,2312845,20.0,341363.0,765,5141599,860,4600128,3502,11713142
493,2022-04-21 15:00:00,384,4800620,404.0,4259169,867.0,2313712,9.0,341372.0,393,5141992,413,4600541,1664,11714806
