,VACCINATION_DATE,FirstDailyDose,FirstDoseCumulative,SecondDailyDose,SecondDoseCumulative,AdditionalDailyDose,AdditionalDoseCumulative,SingleDailyDose,SingleDoseCumulative,AtleastOneVaccine,AtleastOneVaccineCumulative,CompletedVax,CompletedVaxCumulative,FirstSecondSingleVaccinations,FirstSecondSingleVaccinationsCumulative
0,2020-12-14,15,897,,368,,,,,15,897,0,368,15,1175
1,2020-12-15,42,939,2.0,370,,,,,42,939,2,370,44,1219
2,2020-12-16,570,1509,2.0,372,,,,,570,1509,2,372,572,1791
3,2020-12-17,1129,2638,2.0,374,,,,,1129,2638,2,374,1131,2922
4,2020-12-18,3000,5638,10.0,384,,,,,3000,5638,10,384,3010,5932
5,2020-12-19,919,6557,4.0,388,,,,,919,6557,4,388,923,6855
6,2020-12-20,324,6881,4.0,392,,,,,324,6881,4,392,328,7183
7,2020-12-21,3841,10722,17.0,409,,,,,3841,10722,17,409,3858,11041
8,2020-12-22,6316,17038,13.0,422,,,,,6316,17038,13,422,6329,17370
9,2020-12-23,5730,22768,26.0,448,,,,,5730,22768,26,448,5756,23126
10,2020-12-24,2708,25476,8.0,456,,,,,2708,25476,8,456,2716,25842
11,2020-12-25,1033,26509,3.0,459,,,,,1033,26509,3,459,1036,26878
12,2020-12-26,1863,28372,7.0,466,,,,,1863,28372,7,466,1870,28748
13,2020-12-27,1785,30157,9.0,475,,,,,1785,30157,9,475,1794,30542
14,2020-12-28,8925,39082,32.0,507,,,,,8925,39082,32,507,8957,39499
15,2020-12-29,10900,49982,33.0,540,,,,,10900,49982,33,540,10933,50432
16,2020-12-30,12426,62408,63.0,603,,,,,12426,62408,63,603,12489,62921
17,2020-12-31,7493,69901,31.0,634,,,,,7493,69901,31,634,7524,70445
18,2021-01-01,2400,72301,101.0,735,,,,,2400,72301,101,735,2501,72946
19,2021-01-02,2952,75253,32.0,767,,,,,2952,75253,32,767,2984,75930
20,2021-01-03,3356,78609,78.0,845,,,,,3356,78609,78,845,3434,79364
21,2021-01-04,13232,91841,306.0,1151,,,,,13232,91841,306,1151,13538,92902
22,2021-01-05,12358,104199,500.0,1651,,,,,12358,104199,500,1651,12858,105760
23,2021-01-06,15132,119331,822.0,2473,,,,,15132,119331,822,2473,15954,121714
24,2021-01-07,14925,134256,1715.0,4188,,,,,14925,134256,1715,4188,16640,138354
25,2021-01-08,23908,158164,2722.0,6910,,,,,23908,158164,2722,6910,26630,164984
26,2021-01-09,5111,163275,937.0,7847,,,,,5111,163275,937,7847,6048,171032
27,2021-01-10,2898,166173,365.0,8212,,,,,2898,166173,365,8212,3263,174295
28,2021-01-11,13647,179820,3397.0,11609,,,,,13647,179820,3397,11609,17044,191339
29,2021-01-12,17246,197066,5562.0,17171,,,,,17246,197066,5562,17171,22808,214147
30,2021-01-13,18465,215531,3846.0,21017,,,,,18465,215531,3846,21017,22311,236458
31,2021-01-14,17781,233312,1911.0,22928,,,,,17781,233312,1911,22928,19692,256150
32,2021-01-15,19423,252735,1940.0,24868,,,,,19423,252735,1940,24868,21363,277513
33,2021-01-16,5751,258486,1576.0,26444,,,,,5751,258486,1576,26444,7327,284840
34,2021-01-17,2089,260575,1461.0,27905,,,,,2089,260575,1461,27905,3550,288390
35,2021-01-18,7007,267582,3220.0,31125,,,,,7007,267582,3220,31125,10227,298617
36,2021-01-19,17122,284704,5312.0,36437,,,,,17122,284704,5312,36437,22434,321051
37,2021-01-20,21194,305898,5227.0,41664,,,,,21194,305898,5227,41664,26421,347472
38,2021-01-21,23764,329662,3661.0,45325,,,,,23764,329662,3661,45325,27425,374897
39,2021-01-22,28799,358461,3573.0,48898,,,,,28799,358461,3573,48898,32372,407269
40,2021-01-23,10017,368478,1890.0,50788,,,,,10017,368478,1890,50788,11907,419176
41,2021-01-24,3317,371795,1703.0,52491,,,,,3317,371795,1703,52491,5020,424196
42,2021-01-25,16589,388384,8485.0,60976,,,,,16589,388384,8485,60976,25074,449270
43,2021-01-26,17863,406247,8858.0,69834,,,,,17863,406247,8858,69834,26721,475991
44,2021-01-27,25016,431263,12361.0,82195,,,,,25016,431263,12361,82195,37377,513368
45,2021-01-28,23259,454522,9191.0,91386,,,,,23259,454522,9191,91386,32450,545818
46,2021-01-29,25485,480007,7781.0,99167,,,,,25485,480007,7781,99167,33266,579084
47,2021-01-30,18410,498417,2473.0,101640,,,,,18410,498417,2473,101640,20883,599967
48,2021-01-31,4112,502529,1294.0,102934,,,,,4112,502529,1294,102934,5406,605373
49,2021-02-01,7574,510103,4946.0,107880,,,,,7574,510103,4946,107880,12520,617893
50,2021-02-02,12767,522870,13691.0,121571,,,,,12767,522870,13691,121571,26458,644351
51,2021-02-03,18651,541521,18020.0,139591,,,,,18651,541521,18020,139591,36671,681022
52,2021-02-04,22429,563950,15693.0,155284,,,,,22429,563950,15693,155284,38122,719144
53,2021-02-05,20496,584446,17373.0,172657,,,,,20496,584446,17373,172657,37869,757013
54,2021-02-06,12098,596544,14383.0,187040,,,,,12098,596544,14383,187040,26481,783494
55,2021-02-07,5950,602494,1756.0,188796,,,,,5950,602494,1756,188796,7706,791200
56,2021-02-08,13261,615755,13071.0,201867,,,,,13261,615755,13071,201867,26332,817532
57,2021-02-09,16670,632425,13982.0,215849,,,,,16670,632425,13982,215849,30652,848184
58,2021-02-10,19254,651679,21360.0,237209,,,,,19254,651679,21360,237209,40614,888798
59,2021-02-11,22844,674523,17477.0,254686,,,,,22844,674523,17477,254686,40321,929119
60,2021-02-12,20369,694892,19821.0,274507,,,,,20369,694892,19821,274507,40190,969309
61,2021-02-13,11356,706248,6327.0,280834,,,,,11356,706248,6327,280834,17683,986992
62,2021-02-14,7073,713321,2061.0,282895,,,,,7073,713321,2061,282895,9134,996126
63,2021-02-15,11695,725016,13186.0,296081,,,,,11695,725016,13186,296081,24881,1021007
64,2021-02-16,16552,741568,21643.0,317724,,,,,16552,741568,21643,317724,38195,1059202
65,2021-02-17,20602,762170,27102.0,344826,,,,,20602,762170,27102,344826,47704,1106906
66,2021-02-18,3152,765322,4713.0,349539,,,,,3152,765322,4713,349539,7865,1114771
67,2021-02-19,10241,775563,20385.0,369924,,,,,10241,775563,20385,369924,30626,1145397
68,2021-02-20,10289,785852,20849.0,390773,,,,,10289,785852,20849,390773,31138,1176535
69,2021-02-21,6143,791995,7917.0,398690,,,,,6143,791995,7917,398690,14060,1190595
70,2021-02-22,8073,800068,15864.0,414554,,,,,8073,800068,15864,414554,23937,1214532
71,2021-02-23,15575,815643,16447.0,431001,,,,,15575,815643,16447,431001,32022,1246554
72,2021-02-24,17950,833593,25127.0,456128,,,,,17950,833593,25127,456128,43077,1289631
73,2021-02-25,20397,853990,26859.0,482987,,,,,20397,853990,26859,482987,47256,1336887
74,2021-02-26,26801,880791,26417.0,509404,,,,,26801,880791,26417,509404,53218,1390105
75,2021-02-27,16084,896875,11670.0,521074,,,,,16084,896875,11670,521074,27754,1417859
76,2021-02-28,15484,912359,4795.0,525869,,,,,15484,912359,4795,525869,20279,1438138
77,2021-03-01,25849,938208,12490.0,538359,,,,,25849,938208,12490,538359,38339,1476477
78,2021-03-02,23964,962172,13287.0,551646,,,29.0,29.0,23993,962201,13316,551675,37280,1513757
79,2021-03-03,30185,992357,18338.0,569984,,,171.0,200.0,30356,992557,18509,570184,48694,1562451
80,2021-03-04,31052,1023409,18094.0,588078,,,4059.0,4259.0,35111,1027668,22153,592337,53205,1615656
81,2021-03-05,29540,1052949,19343.0,607421,,,4906.0,9165.0,34446,1062114,24249,616586,53789,1669445
82,2021-03-06,17747,1070696,8894.0,616315,,,5986.0,15151.0,23733,1085847,14880,631466,32627,1702072
83,2021-03-07,12058,1082754,4785.0,621100,,,6610.0,21761.0,18668,1104515,11395,642861,23453,1725525
84,2021-03-08,26156,1108910,8724.0,629824,,,8284.0,30045.0,34440,1138955,17008,659869,43164,1768689
85,2021-03-09,26364,1135274,15350.0,645174,,,8343.0,38388.0,34707,1173662,23693,683562,50057,1818746
86,2021-03-10,30108,1165382,15871.0,661045,,,7939.0,46327.0,38047,1211709,23810,707372,53918,1872664
87,2021-03-11,36171,1201553,16363.0,677408,,,4035.0,50362.0,40206,1251915,20398,727770,56569,1929233
88,2021-03-12,37162,1238715,17977.0,695385,,,2916.0,53278.0,40078,1291993,20893,748663,58055,1987288
89,2021-03-13,22588,1261303,10188.0,705573,,,1600.0,54878.0,24188,1316181,11788,760451,34376,2021664
90,2021-03-14,17836,1279139,6647.0,712220,,,993.0,55871.0,18829,1335010,7640,768091,25476,2047140
91,2021-03-15,29969,1309108,11291.0,723511,,,595.0,56466.0,30564,1365574,11886,779977,41855,2088995
92,2021-03-16,33606,1342714,13513.0,737024,,,764.0,57230.0,34370,1399944,14277,794254,47883,2136878
93,2021-03-17,37733,1380447,16930.0,753954,,,1181.0,58411.0,38914,1438858,18111,812365,55844,2192722
94,2021-03-18,41462,1421909,12573.0,766527,,,1358.0,59769.0,42820,1481678,13931,826296,55393,2248115
95,2021-03-19,38287,1460196,15557.0,782084,,,1044.0,60813.0,39331,1521009,16601,842897,54888,2303003
96,2021-03-20,24514,1484710,9999.0,792083,,,1120.0,61933.0,25634,1546643,11119,854016,35633,2338636
97,2021-03-21,19121,1503831,7772.0,799855,,,328.0,62261.0,19449,1566092,8100,862116,27221,2365857
98,2021-03-22,32586,1536417,11599.0,811454,,,828.0,63089.0,33414,1599506,12427,874543,45013,2410870
99,2021-03-23,37795,1574212,17437.0,828891,,,1543.0,64632.0,39338,1638844,18980,893523,56775,2467645
100,2021-03-24,41169,1615381,21141.0,850032,,,1374.0,66006.0,42543,1681387,22515,916038,63684,2531329
101,2021-03-25,42470,1657851,20993.0,871025,,,2512.0,68518.0,44982,1726369,23505,939543,65975,2597304
102,2021-03-26,36611,1694462,26430.0,897455,,,2499.0,71017.0,39110,1765479,28929,968472,65540,2662844
103,2021-03-27,27841,1722303,16844.0,914299,,,2764.0,73781.0,30605,1796084,19608,988080,47449,2710293
104,2021-03-28,17012,1739315,12547.0,926846,,,1614.0,75395.0,18626,1814710,14161,1002241,31173,2741466
105,2021-03-29,29747,1769062,26482.0,953328,,,1134.0,76529.0,30881,1845591,27616,1029857,57363,2798829
106,2021-03-30,40061,1809123,29120.0,982448,,,1847.0,78376.0,41908,1887499,30967,1060824,71028,2869857
107,2021-03-31,41065,1850188,34821.0,1017269,,,5744.0,84120.0,46809,1934308,40565,1101389,81630,2951487
108,2021-04-01,40584,1890772,39704.0,1056973,,,5605.0,89725.0,46189,1980497,45309,1146698,85893,3037380
109,2021-04-02,34945,1925717,32690.0,1089663,,,6091.0,95816.0,41036,2021533,38781,1185479,73726,3111106
110,2021-04-03,21579,1947296,18610.0,1108273,,,4422.0,100238.0,26001,2047534,23032,1208511,44611,3155717
111,2021-04-04,8276,1955572,10130.0,1118403,,,959.0,101197.0,9235,2056769,11089,1219600,19365,3175082
112,2021-04-05,27950,1983522,29051.0,1147454,,,6636.0,107833.0,34586,2091355,35687,1255287,63637,3238719
113,2021-04-06,39892,2023414,30537.0,1177991,,,10470.0,118303.0,50362,2141717,41007,1296294,80899,3319618
114,2021-04-07,36167,2059581,34249.0,1212240,,,12944.0,131247.0,49111,2190828,47193,1343487,83360,3402978
115,2021-04-08,42421,2102002,36037.0,1248277,,,13858.0,145105.0,56279,2247107,49895,1393382,92316,3495294
116,2021-04-09,34116,2136118,36340.0,1284617,,,14490.0,159595.0,48606,2295713,50830,1444212,84946,3580240
117,2021-04-10,24003,2160121,22989.0,1307606,,,7614.0,167209.0,31617,2327330,30603,1474815,54606,3634846
118,2021-04-11,17553,2177674,13238.0,1320844,,,10623.0,177832.0,28176,2355506,23861,1498676,41414,3676260
119,2021-04-12,24689,2202363,33134.0,1353978,,,10930.0,188762.0,35619,2391125,44064,1542740,68753,3745013
120,2021-04-13,126927,2329290,90651.0,1444629,,,3292.0,192054.0,130219,2521344,93943,1636683,220870,3965883
121,2021-04-14,40822,2370112,37845.0,1482474,,,209.0,192263.0,41031,2562375,38054,1674737,78876,4044759
122,2021-04-15,41852,2411964,39210.0,1521684,,,169.0,192432.0,42021,2604396,39379,1714116,81231,4125990
123,2021-04-16,37369,2449333,38731.0,1560415,,,22.0,192454.0,37391,2641787,38753,1752869,76122,4202112
124,2021-04-17,32994,2482327,21926.0,1582341,,,12.0,192466.0,33006,2674793,21938,1774807,54932,4257044
125,2021-04-18,20016,2502343,16127.0,1598468,,,4.0,192470.0,20020,2694813,16131,1790938,36147,4293191
126,2021-04-19,29950,2532293,36514.0,1634982,,,61.0,192531.0,30011,2724824,36575,1827513,66525,4359716
127,2021-04-20,33112,2565405,44094.0,1679076,,,55.0,192586.0,33167,2757991,44149,1871662,77261,4436977
128,2021-04-21,39810,2605215,46850.0,1725926,,,21.0,192607.0,39831,2797822,46871,1918533,86681,4523658
129,2021-04-22,36407,2641622,41891.0,1767817,,,16.0,192623.0,36423,2834245,41907,1960440,78314,4601972
130,2021-04-23,33140,2674762,39959.0,1807776,,,12.0,192635.0,33152,2867397,39971,2000411,73111,4675083
131,2021-04-24,26359,2701121,28574.0,1836350,,,80.0,192715.0,26439,2893836,28654,2029065,55013,4730096
132,2021-04-25,20203,2721324,10886.0,1847236,,,30.0,192745.0,20233,2914069,10916,2039981,31119,4761215
133,2021-04-26,27408,2748732,32732.0,1879968,,,203.0,192948.0,27611,2941680,32935,2072916,60343,4821558
134,2021-04-27,26715,2775447,33004.0,1912972,,,1095.0,194043.0,27810,2969490,34099,2107015,60814,4882372
135,2021-04-28,28986,2804433,39447.0,1952419,,,1360.0,195403.0,30346,2999836,40807,2147822,69793,4952165
136,2021-04-29,27383,2831816,39395.0,1991814,,,1462.0,196865.0,28845,3028681,40857,2188679,68240,5020405
137,2021-04-30,28231,2860047,32090.0,2023904,,,1639.0,198504.0,29870,3058551,33729,2222408,61960,5082365
138,2021-05-01,20288,2880335,26659.0,2050563,,,1015.0,199519.0,21303,3079854,27674,2250082,47962,5130327
139,2021-05-02,10256,2890591,16982.0,2067545,,,818.0,200337.0,11074,3090928,17800,2267882,28056,5158383
140,2021-05-03,13064,2903655,29713.0,2097258,,,1914.0,202251.0,14978,3105906,31627,2299509,44691,5203074
141,2021-05-04,14213,2917868,39510.0,2136768,,,1733.0,203984.0,15946,3121852,41243,2340752,55456,5258530
142,2021-05-05,19318,2937186,37744.0,2174512,,,1917.0,205901.0,21235,3143087,39661,2380413,58979,5317509
143,2021-05-06,16977,2954163,40548.0,2215060,,,1711.0,207612.0,18688,3161775,42259,2422672,59236,5376745
144,2021-05-07,17402,2971565,36005.0,2251065,,,1952.0,209564.0,19354,3181129,37957,2460629,55359,5432104
145,2021-05-08,10780,2982345,31123.0,2282188,,,1291.0,210855.0,12071,3193200,32414,2493043,43194,5475298
146,2021-05-09,5059,2987404,11861.0,2294049,,,695.0,211550.0,5754,3198954,12556,2505599,17615,5492913
147,2021-05-10,8939,2996343,31098.0,2325147,,,1357.0,212907.0,10296,3209250,32455,2538054,41394,5534307
148,2021-05-11,12192,3008535,30273.0,2355420,,,1443.0,214350.0,13635,3222885,31716,2569770,43908,5578215
149,2021-05-12,13909,3022444,38541.0,2393961,,,1909.0,216259.0,15818,3238703,40450,2610220,54359,5632574
150,2021-05-13,21810,3044254,33371.0,2427332,,,1352.0,217611.0,23162,3261865,34723,2644943,56533,5689107
151,2021-05-14,24314,3068568,29953.0,2457285,,,1770.0,219381.0,26084,3287949,31723,2676666,56037,5745144
152,2021-05-15,21836,3090404,24997.0,2482282,,,1532.0,220913.0,23368,3311317,26529,2703195,48365,5793509
153,2021-05-16,9057,3099461,17504.0,2499786,,,1113.0,222026.0,10170,3321487,18617,2721812,27674,5821183
154,2021-05-17,16844,3116305,28355.0,2528141,,,1948.0,223974.0,18792,3340279,30303,2752115,47147,5868330
155,2021-05-18,21246,3137551,30670.0,2558811,,,1947.0,225921.0,23193,3363472,32617,2784732,53863,5922193
156,2021-05-19,27575,3165126,32360.0,2591171,,,1623.0,227544.0,29198,3392670,33983,2818715,61558,5983751
157,2021-05-20,20779,3185905,33253.0,2624424,,,1965.0,229509.0,22744,3415414,35218,2853933,55997,6039748
158,2021-05-21,19124,3205029,30220.0,2654644,,,1612.0,231121.0,20736,3436150,31832,2885765,50956,6090704
159,2021-05-22,16873,3221902,20592.0,2675236,,,1270.0,232391.0,18143,3454293,21862,2907627,38735,6129439
160,2021-05-23,8740,3230642,11406.0,2686642,,,960.0,233351.0,9700,3463993,12366,2919993,21106,6150545
161,2021-05-24,13454,3244096,17847.0,2704489,,,1481.0,234832.0,14935,3478928,19328,2939321,32782,6183327
162,2021-05-25,12886,3256982,18761.0,2723250,,,1328.0,236160.0,14214,3493142,20089,2959410,32975,6216302
163,2021-05-26,18258,3275240,19433.0,2742683,,,1508.0,237668.0,19766,3512908,20941,2980351,39199,6255501
164,2021-05-27,11675,3286915,18626.0,2761309,,,1133.0,238801.0,12808,3525716,19759,3000110,31434,6286935
165,2021-05-28,12472,3299387,19727.0,2781036,,,1402.0,240203.0,13874,3539590,21129,3021239,33601,6320536
166,2021-05-29,9532,3308919,11618.0,2792654,,,936.0,241139.0,10468,3550058,12554,3033793,22086,6342622
167,2021-05-30,4892,3313811,6471.0,2799125,,,596.0,241735.0,5488,3555546,7067,3040860,11959,6354581
168,2021-05-31,1771,3315582,3684.0,2802809,,,304.0,242039.0,2075,3557621,3988,3044848,5759,6360340
169,2021-06-01,9367,3324949,16571.0,2819380,,,1143.0,243182.0,10510,3568131,17714,3062562,27081,6387421
170,2021-06-02,10138,3335087,16797.0,2836177,,,960.0,244142.0,11098,3579229,17757,3080319,27895,6415316
171,2021-06-03,7889,3342976,21153.0,2857330,,,1083.0,245225.0,8972,3588201,22236,3102555,30125,6445441
172,2021-06-04,8212,3351188,22159.0,2879489,,,1123.0,246348.0,9335,3597536,23282,3125837,31494,6476935
173,2021-06-05,6988,3358176,19362.0,2898851,,,718.0,247066.0,7706,3605242,20080,3145917,27068,6504003
174,2021-06-06,3465,3361641,7178.0,2906029,,,420.0,247486.0,3885,3609127,7598,3153515,11063,6515066
175,2021-06-07,6822,3368463,15713.0,2921742,,,725.0,248211.0,7547,3616674,16438,3169953,23260,6538326
176,2021-06-08,6675,3375138,19682.0,2941424,,,816.0,249027.0,7491,3624165,20498,3190451,27173,6565499
177,2021-06-09,8197,3383335,23835.0,2965259,,,968.0,249995.0,9165,3633330,24803,3215254,33000,6598499
178,2021-06-10,7164,3390499,19066.0,2984325,,,897.0,250892.0,8061,3641391,19963,3235217,27127,6625626
179,2021-06-11,7433,3397932,17647.0,3001972,,,1125.0,252017.0,8558,3649949,18772,3253989,26205,6651831
180,2021-06-12,5234,3403166,14675.0,3016647,,,602.0,252619.0,5836,3655785,15277,3269266,20511,6672342
181,2021-06-13,1930,3405096,7549.0,3024196,,,426.0,253045.0,2356,3658141,7975,3277241,9905,6682247
182,2021-06-14,5652,3410748,11771.0,3035967,,,727.0,253772.0,6379,3664520,12498,3289739,18150,6700397
183,2021-06-15,5634,3416382,14299.0,3050266,,,859.0,254631.0,6493,3671013,15158,3304897,20792,6721189
184,2021-06-16,8711,3425093,21495.0,3071761,,,753.0,255384.0,9464,3680477,22248,3327145,30959,6752148
185,2021-06-17,6668,3431761,12356.0,3084117,,,720.0,256104.0,7388,3687865,13076,3340221,19744,6771892
186,2021-06-18,6832,3438593,12634.0,3096751,,,694.0,256798.0,7526,3695391,13328,3353549,20160,6792052
187,2021-06-19,4655,3443248,9341.0,3106092,,,614.0,257412.0,5269,3700660,9955,3363504,14610,6806662
188,2021-06-20,2496,3445744,5021.0,3111113,,,377.0,257789.0,2873,3703533,5398,3368902,7894,6814556
189,2021-06-21,5541,3451285,5304.0,3116417,,,635.0,258424.0,6176,3709709,5939,3374841,11480,6826036
190,2021-06-22,5193,3456478,8844.0,3125261,,,681.0,259105.0,5874,3715583,9525,3384366,14718,6840754
191,2021-06-23,6056,3462534,10263.0,3135524,,,641.0,259746.0,6697,3722280,10904,3395270,16960,6857714
192,2021-06-24,5918,3468452,8174.0,3143698,,,590.0,260336.0,6508,3728788,8764,3404034,14682,6872396
193,2021-06-25,5810,3474262,8599.0,3152297,,,620.0,260956.0,6430,3735218,9219,3413253,15029,6887425
194,2021-06-26,3700,3477962,6266.0,3158563,,,393.0,261349.0,4093,3739311,6659,3419912,10359,6897784
195,2021-06-27,2792,3480754,3529.0,3162092,,,182.0,261531.0,2974,3742285,3711,3423623,6503,6904287
196,2021-06-28,4722,3485476,6084.0,3168176,,,521.0,262052.0,5243,3747528,6605,3430228,11327,6915614
197,2021-06-29,5063,3490539,6485.0,3174661,,,517.0,262569.0,5580,3753108,7002,3437230,12065,6927679
198,2021-06-30,5587,3496126,7391.0,3182052,,,603.0,263172.0,6190,3759298,7994,3445224,13581,6941260
199,2021-07-01,5279,3501405,6908.0,3188960,,,486.0,263658.0,5765,3765063,7394,3452618,12673,6953933
200,2021-07-02,5262,3506667,6812.0,3195772,,,518.0,264176.0,5780,3770843,7330,3459948,12592,6966525
201,2021-07-03,3255,3509922,4061.0,3199833,,,260.0,264436.0,3515,3774358,4321,3464269,7576,6974101
202,2021-07-04,490,3510412,540.0,3200373,,,66.0,264502.0,556,3774914,606,3464875,1096,6975197
203,2021-07-05,3746,3514158,3955.0,3204328,,,280.0,264782.0,4026,3778940,4235,3469110,7981,6983178
204,2021-07-06,4458,3518616,6202.0,3210530,,,450.0,265232.0,4908,3783848,6652,3475762,11110,6994288
205,2021-07-07,4461,3523077,6347.0,3216877,,,480.0,265712.0,4941,3788789,6827,3482589,11288,7005576
206,2021-07-08,4816,3527893,6099.0,3222976,,,562.0,266274.0,5378,3794167,6661,3489250,11477,7017053
207,2021-07-09,5320,3533213,6604.0,3229580,,,571.0,266845.0,5891,3800058,7175,3496425,12495,7029548
208,2021-07-10,3508,3536721,4364.0,3233944,,,302.0,267147.0,3810,3803868,4666,3501091,8174,7037722
209,2021-07-11,2661,3539382,2546.0,3236490,,,223.0,267370.0,2884,3806752,2769,3503860,5430,7043152
210,2021-07-12,4395,3543777,5098.0,3241588,,,374.0,267744.0,4769,3811521,5472,3509332,9867,7053019
211,2021-07-13,4730,3548507,4571.0,3246159,,,361.0,268105.0,5091,3816612,4932,3514264,9662,7062681
212,2021-07-14,4593,3553100,5231.0,3251390,,,420.0,268525.0,5013,3821625,5651,3519915,10244,7072925
213,2021-07-15,4861,3557961,4957.0,3256347,,,357.0,268882.0,5218,3826843,5314,3525229,10175,7083100
214,2021-07-16,6260,3564221,5796.0,3262143,,,400.0,269282.0,6660,3833503,6196,3531425,12456,7095556
215,2021-07-17,3402,3567623,3545.0,3265688,,,299.0,269581.0,3701,3837204,3844,3535269,7246,7102802
216,2021-07-18,2296,3569919,2365.0,3268053,,,109.0,269690.0,2405,3839609,2474,3537743,4770,7107572
217,2021-07-19,5220,3575139,4457.0,3272510,,,374.0,270064.0,5594,3845203,4831,3542574,10051,7117623
218,2021-07-20,5319,3580458,4674.0,3277184,,,366.0,270430.0,5685,3850888,5040,3547614,10359,7127982
219,2021-07-21,5608,3586066,4916.0,3282100,,,412.0,270842.0,6020,3856908,5328,3552942,10936,7138918
220,2021-07-22,5982,3592048,4624.0,3286724,,,404.0,271246.0,6386,3863294,5028,3557970,11010,7149928
221,2021-07-23,6811,3598859,4857.0,3291581,,,488.0,271734.0,7299,3870593,5345,3563315,12156,7162084
222,2021-07-24,4269,3603128,3195.0,3294776,,,264.0,271998.0,4533,3875126,3459,3566774,7728,7169812
223,2021-07-25,3288,3606416,1116.0,3295892,,,138.0,272136.0,3426,3878552,1254,3568028,4542,7174354
224,2021-07-26,6185,3612601,3899.0,3299791,,,409.0,272545.0,6594,3885146,4308,3572336,10493,7184847
225,2021-07-27,6329,3618930,4057.0,3303848,,,450.0,272995.0,6779,3891925,4507,3576843,10836,7195683
226,2021-07-28,6775,3625705,4004.0,3307852,,,452.0,273447.0,7227,3899152,4456,3581299,11231,7206914
227,2021-07-29,6780,3632485,4145.0,3311997,,,410.0,273857.0,7190,3906342,4555,3585854,11335,7218249
228,2021-07-30,7491,3639976,4512.0,3316509,,,517.0,274374.0,8008,3914350,5029,3590883,12520,7230769
229,2021-07-31,4778,3644754,3041.0,3319550,,,271.0,274645.0,5049,3919399,3312,3594195,8090,7238859
230,2021-08-01,3733,3648487,2081.0,3321631,42.0,42.0,152.0,274797.0,3885,3923284,2233,3596428,6008,7244867
231,2021-08-02,6988,3655475,3652.0,3325283,46.0,88.0,332.0,275129.0,7320,3930604,3984,3600412,11018,7255885
232,2021-08-03,6957,3662432,3891.0,3329174,25.0,113.0,502.0,275631.0,7459,3938063,4393,3604805,11375,7267260
233,2021-08-04,7139,3669571,3893.0,3333067,34.0,147.0,527.0,276158.0,7666,3945729,4420,3609225,11593,7278853
234,2021-08-05,7621,3677192,4108.0,3337175,38.0,185.0,534.0,276692.0,8155,3953884,4642,3613867,12301,7291154
235,2021-08-06,8245,3685437,4695.0,3341870,44.0,229.0,448.0,277140.0,8693,3962577,5143,3619010,13432,7304586
236,2021-08-07,5230,3690667,2792.0,3344662,41.0,270.0,262.0,277402.0,5492,3968069,3054,3622064,8325,7312911
237,2021-08-08,3935,3694602,2044.0,3346706,24.0,294.0,140.0,277542.0,4075,3972144,2184,3624248,6143,7319054
238,2021-08-09,6898,3701500,4497.0,3351203,29.0,323.0,361.0,277903.0,7259,3979403,4858,3629106,11785,7330839
239,2021-08-10,7090,3708590,4438.0,3355641,34.0,357.0,334.0,278237.0,7424,3986827,4772,3633878,11896,7342735
240,2021-08-11,7012,3715602,4416.0,3360057,36.0,393.0,438.0,278675.0,7450,3994277,4854,3638732,11902,7354637
241,2021-08-12,8537,3724139,4687.0,3364744,66.0,459.0,437.0,279112.0,8974,4003251,5124,3643856,13727,7368364
242,2021-08-13,7074,3731213,5327.0,3370071,91.0,550.0,381.0,279493.0,7455,4010706,5708,3649564,12873,7381237
243,2021-08-14,4908,3736121,3335.0,3373406,588.0,1138.0,282.0,279775.0,5190,4015896,3617,3653181,9113,7390350
244,2021-08-15,3313,3739434,2727.0,3376133,513.0,1651.0,163.0,279938.0,3476,4019372,2890,3656071,6716,7397066
245,2021-08-16,5378,3744812,5051.0,3381184,1137.0,2788.0,348.0,280286.0,5726,4025098,5399,3661470,11914,7408980
246,2021-08-17,6904,3751716,5172.0,3386356,1314.0,4102.0,385.0,280671.0,7289,4032387,5557,3667027,13775,7422755
247,2021-08-18,6476,3758192,5267.0,3391623,1491.0,5593.0,463.0,281134.0,6939,4039326,5730,3672757,13697,7436452
248,2021-08-19,5954,3764146,5302.0,3396925,1519.0,7112.0,407.0,281541.0,6361,4045687,5709,3678466,13182,7449634
249,2021-08-20,6979,3771125,6292.0,3403217,1555.0,8667.0,399.0,281940.0,7378,4053065,6691,3685157,15225,7464859
250,2021-08-21,4302,3775427,3912.0,3407129,795.0,9462.0,223.0,282163.0,4525,4057590,4135,3689292,9232,7474091
251,2021-08-22,3059,3778486,3150.0,3410279,752.0,10214.0,109.0,282272.0,3168,4060758,3259,3692551,7070,7481161
252,2021-08-23,6139,3784625,5886.0,3416165,1682.0,11896.0,284.0,282556.0,6423,4067181,6170,3698721,13991,7495152
253,2021-08-24,6604,3791229,5829.0,3421994,1568.0,13464.0,422.0,282978.0,7026,4074207,6251,3704972,14423,7509575
254,2021-08-25,6849,3798078,5977.0,3427971,1461.0,14925.0,432.0,283410.0,7281,4081488,6409,3711381,14719,7524294
255,2021-08-26,7141,3805219,6376.0,3434347,1620.0,16545.0,425.0,283835.0,7566,4089054,6801,3718182,15562,7539856
256,2021-08-27,6812,3812031,6973.0,3441320,1869.0,18414.0,314.0,284149.0,7126,4096180,7287,3725469,15968,7555824
257,2021-08-28,6901,3818932,6458.0,3447778,940.0,19354.0,324.0,284473.0,7225,4103405,6782,3732251,14623,7570447
258,2021-08-29,3746,3822678,3669.0,3451447,623.0,19977.0,611.0,285084.0,4357,4107762,4280,3736531,8649,7579096
259,2021-08-30,5913,3828591,6065.0,3457512,1415.0,21392.0,946.0,286030.0,6859,4114621,7011,3743542,14339,7593435
260,2021-08-31,5661,3834252,5905.0,3463417,1494.0,22886.0,945.0,286975.0,6606,4121227,6850,3750392,14005,7607440
261,2021-09-01,5478,3839730,5544.0,3468961,1415.0,24301.0,894.0,287869.0,6372,4127599,6438,3756830,13331,7620771
262,2021-09-02,5513,3845243,5846.0,3474807,1707.0,26008.0,698.0,288567.0,6211,4133810,6544,3763374,13764,7634535
263,2021-09-03,5950,3851193,6848.0,3481655,1686.0,27694.0,967.0,289534.0,6917,4140727,7815,3771189,15451,7649986
264,2021-09-04,3718,3854911,4294.0,3485949,816.0,28510.0,875.0,290409.0,4593,4145320,5169,3776358,9703,7659689
265,2021-09-05,2879,3857790,2787.0,3488736,605.0,29115.0,105.0,290514.0,2984,4148304,2892,3779250,6376,7666065
266,2021-09-06,1041,3858831,1140.0,3489876,180.0,29295.0,62.0,290576.0,1103,4149407,1202,3780452,2423,7668488
267,2021-09-07,5267,3864098,7205.0,3497081,1282.0,30577.0,2299.0,292875.0,7566,4156973,9504,3789956,16053,7684541
268,2021-09-08,4643,3868741,5416.0,3502497,1463.0,32040.0,365.0,293240.0,5008,4161981,5781,3795737,11887,7696428
269,2021-09-09,5032,3873773,5307.0,3507804,2116.0,34156.0,321.0,293561.0,5353,4167334,5628,3801365,12776,7709204
270,2021-09-10,6486,3880259,6529.0,3514333,2290.0,36446.0,1707.0,295268.0,8193,4175527,8236,3809601,17012,7726216
271,2021-09-11,4025,3884284,4312.0,3518645,936.0,37382.0,661.0,295929.0,4686,4180213,4973,3814574,9934,7736150
272,2021-09-12,3052,3887336,3220.0,3521865,668.0,38050.0,433.0,296362.0,3485,4183698,3653,3818227,7373,7743523
273,2021-09-13,4640,3891976,4802.0,3526667,1414.0,39464.0,346.0,296708.0,4986,4188684,5148,3823375,11202,7754725
274,2021-09-14,4543,3896519,5180.0,3531847,1455.0,40919.0,431.0,297139.0,4974,4193658,5611,3828986,11609,7766334
275,2021-09-15,4664,3901183,5548.0,3537395,1317.0,42236.0,383.0,297522.0,5047,4198705,5931,3834917,11912,7778246
276,2021-09-16,4543,3905726,5541.0,3542936,1461.0,43697.0,326.0,297848.0,4869,4203574,5867,3840784,11871,7790117
277,2021-09-17,4957,3910683,6255.0,3549191,1728.0,45425.0,333.0,298181.0,5290,4208864,6588,3847372,13273,7803390
278,2021-09-18,3732,3914415,4542.0,3553733,857.0,46282.0,183.0,298364.0,3915,4212779,4725,3852097,9314,7812704
279,2021-09-19,2707,3917122,3142.0,3556875,628.0,46910.0,75.0,298439.0,2782,4215561,3217,3855314,6552,7819256
280,2021-09-20,3493,3920615,4418.0,3561293,1567.0,48477.0,426.0,298865.0,3919,4219480,4844,3860158,9904,7829160
281,2021-09-21,3743,3924358,4739.0,3566032,1663.0,50140.0,319.0,299184.0,4062,4223542,5058,3865216,10464,7839624
282,2021-09-22,4108,3928466,4669.0,3570701,1566.0,51706.0,451.0,299635.0,4559,4228101,5120,3870336,10794,7850418
283,2021-09-23,4133,3932599,4651.0,3575352,2029.0,53735.0,486.0,300121.0,4619,4232720,5137,3875473,11299,7861717
284,2021-09-24,4999,3937598,5467.0,3580819,4523.0,58258.0,414.0,300535.0,5413,4238133,5881,3881354,15403,7877120
285,2021-09-25,3566,3941164,3607.0,3584426,4712.0,62970.0,384.0,300919.0,3950,4242083,3991,3885345,12269,7889389
286,2021-09-26,2310,3943474,2588.0,3587014,2928.0,65898.0,421.0,301340.0,2731,4244814,3009,3888354,8247,7897636
287,2021-09-27,4244,3947718,2497.0,3589511,8047.0,73945.0,505.0,301845.0,4749,4249563,3002,3891356,15293,7912929
288,2021-09-28,4294,3952012,4276.0,3593787,8924.0,82869.0,210.0,302055.0,4504,4254067,4486,3895842,17704,7930633
289,2021-09-29,4423,3956435,4257.0,3598044,8738.0,91607.0,901.0,302956.0,5324,4259391,5158,3901000,18319,7948952
290,2021-09-30,4545,3960980,4199.0,3602243,8569.0,100176.0,771.0,303727.0,5316,4264707,4970,3905970,18084,7967036
291,2021-10-01,4895,3965875,4807.0,3607050,9991.0,110167.0,734.0,304461.0,5629,4270336,5541,3911511,20427,7987463
292,2021-10-02,2572,3968447,2588.0,3609638,4800.0,114967.0,166.0,304627.0,2738,4273074,2754,3914265,10126,7997589
293,2021-10-03,1767,3970214,1914.0,3611552,2909.0,117876.0,57.0,304684.0,1824,4274898,1971,3916236,6647,8004236
294,2021-10-04,2911,3973125,2252.0,3613804,6158.0,124034.0,187.0,304871.0,3098,4277996,2439,3918675,11508,8015744
295,2021-10-05,1169,3974294,911.0,3614715,2649.0,126683.0,140.0,305011.0,1309,4279305,1051,3919726,4869,8020613
