,VACCINATION_DATE,FirstDailyDose,FirstDoseCumulative,SecondDailyDose,SecondDoseCumulative,AdditionalDailyDose,AdditionalDoseCumulative,SingleDailyDose,SingleDoseCumulative,AtleastOneVaccine,AtleastOneVaccineCumulative,CompletedVax,CompletedVaxCumulative,FirstSecondSingleVaccinations,FirstSecondSingleVaccinationsCumulative
0,2020-12-14,19,1402,,523,,,,,19,1402,0,523,19,1821
1,2020-12-15,61,1463,3.0,526,,,,,61,1463,3,526,64,1885
2,2020-12-16,595,2058,5.0,531,,,,,595,2058,5,531,600,2485
3,2020-12-17,1164,3222,8.0,539,,,,,1164,3222,8,539,1172,3657
4,2020-12-18,3021,6243,12.0,551,,,,,3021,6243,12,551,3033,6690
5,2020-12-19,931,7174,5.0,556,,,,,931,7174,5,556,936,7626
6,2020-12-20,364,7538,6.0,562,,,,,364,7538,6,562,370,7996
7,2020-12-21,3889,11427,26.0,588,,,,,3889,11427,26,588,3915,11911
8,2020-12-22,6323,17750,27.0,615,,,,,6323,17750,27,615,6350,18261
9,2020-12-23,5784,23534,36.0,651,,,,,5784,23534,36,651,5820,24081
10,2020-12-24,2728,26262,15.0,666,,,,,2728,26262,15,666,2743,26824
11,2020-12-25,1035,27297,4.0,670,,,,,1035,27297,4,670,1039,27863
12,2020-12-26,1883,29180,9.0,679,,,,,1883,29180,9,679,1892,29755
13,2020-12-27,1802,30982,12.0,691,,,,,1802,30982,12,691,1814,31569
14,2020-12-28,8983,39965,50.0,741,,,,,8983,39965,50,741,9033,40602
15,2020-12-29,10968,50933,53.0,794,,,,,10968,50933,53,794,11021,51623
16,2020-12-30,12491,63424,92.0,886,,,,,12491,63424,92,886,12583,64206
17,2020-12-31,7552,70976,47.0,933,,,,,7552,70976,47,933,7599,71805
18,2021-01-01,3301,74277,141.0,1074,,,,,3301,74277,141,1074,3442,75247
19,2021-01-02,3044,77321,34.0,1108,,,,,3044,77321,34,1108,3078,78325
20,2021-01-03,3411,80732,82.0,1190,,,,,3411,80732,82,1190,3493,81818
21,2021-01-04,13363,94095,336.0,1526,,,,,13363,94095,336,1526,13699,95517
22,2021-01-05,12486,106581,548.0,2074,,,,,12486,106581,548,2074,13034,108551
23,2021-01-06,15267,121848,864.0,2938,,,,,15267,121848,864,2938,16131,124682
24,2021-01-07,15038,136886,1777.0,4715,,,,,15038,136886,1777,4715,16815,141497
25,2021-01-08,24013,160899,2785.0,7500,,,,,24013,160899,2785,7500,26798,168295
26,2021-01-09,5175,166074,954.0,8454,,,,,5175,166074,954,8454,6129,174424
27,2021-01-10,2971,169045,384.0,8838,,,,,2971,169045,384,8838,3355,177779
28,2021-01-11,13722,182767,3470.0,12308,,,,,13722,182767,3470,12308,17192,194971
29,2021-01-12,17392,200159,5593.0,17901,,,,,17392,200159,5593,17901,22985,217956
30,2021-01-13,18619,218778,3928.0,21829,,,,,18619,218778,3928,21829,22547,240503
31,2021-01-14,17853,236631,1962.0,23791,,,,,17853,236631,1962,23791,19815,260318
32,2021-01-15,19482,256113,2033.0,25824,,,,,19482,256113,2033,25824,21515,281833
33,2021-01-16,5837,261950,1617.0,27441,,,,,5837,261950,1617,27441,7454,289287
34,2021-01-17,2122,264072,1480.0,28921,,,,,2122,264072,1480,28921,3602,292889
35,2021-01-18,7079,271151,3260.0,32181,,,,,7079,271151,3260,32181,10339,303228
36,2021-01-19,16956,288107,5405.0,37586,,,,,16956,288107,5405,37586,22361,325589
37,2021-01-20,21007,309114,5324.0,42910,,,,,21007,309114,5324,42910,26331,351920
38,2021-01-21,23811,332925,3848.0,46758,,,,,23811,332925,3848,46758,27659,379579
39,2021-01-22,28658,361583,3757.0,50515,,,,,28658,361583,3757,50515,32415,411994
40,2021-01-23,10122,371705,1943.0,52458,,,,,10122,371705,1943,52458,12065,424059
41,2021-01-24,3355,375060,1723.0,54181,,,,,3355,375060,1723,54181,5078,429137
42,2021-01-25,16307,391367,8605.0,62786,,,,,16307,391367,8605,62786,24912,454049
43,2021-01-26,17564,408931,8977.0,71763,,,,,17564,408931,8977,71763,26541,480590
44,2021-01-27,24437,433368,12552.0,84315,,,,,24437,433368,12552,84315,36989,517579
45,2021-01-28,22656,456024,9330.0,93645,,,,,22656,456024,9330,93645,31986,549565
46,2021-01-29,24786,480810,7928.0,101573,,,,,24786,480810,7928,101573,32714,582279
47,2021-01-30,17783,498593,2561.0,104134,,,,,17783,498593,2561,104134,20344,602623
48,2021-01-31,3765,502358,1370.0,105504,,,,,3765,502358,1370,105504,5135,607758
49,2021-02-01,8128,510486,5390.0,110894,,,,,8128,510486,5390,110894,13518,621276
50,2021-02-02,12510,522996,13827.0,124721,,,,,12510,522996,13827,124721,26337,647613
51,2021-02-03,18260,541256,18134.0,142855,,,,,18260,541256,18134,142855,36394,684007
52,2021-02-04,22133,563389,15790.0,158645,,,,,22133,563389,15790,158645,37923,721930
53,2021-02-05,20347,583736,17424.0,176069,,,,,20347,583736,17424,176069,37771,759701
54,2021-02-06,11333,595069,14478.0,190547,,,,,11333,595069,14478,190547,25811,785512
55,2021-02-07,5950,601019,1839.0,192386,,,,,5950,601019,1839,192386,7789,793301
56,2021-02-08,12986,614005,12924.0,205310,,,,,12986,614005,12924,205310,25910,819211
57,2021-02-09,16651,630656,13878.0,219188,,,,,16651,630656,13878,219188,30529,849740
58,2021-02-10,19304,649960,21235.0,240423,,,,,19304,649960,21235,240423,40539,890279
59,2021-02-11,22853,672813,17344.0,257767,,,,,22853,672813,17344,257767,40197,930476
60,2021-02-12,20399,693212,19639.0,277406,,,,,20399,693212,19639,277406,40038,970514
61,2021-02-13,11438,704650,6425.0,283831,,,,,11438,704650,6425,283831,17863,988377
62,2021-02-14,7113,711763,2131.0,285962,,,,,7113,711763,2131,285962,9244,997621
63,2021-02-15,11763,723526,13337.0,299299,,,,,11763,723526,13337,299299,25100,1022721
64,2021-02-16,16612,740138,21020.0,320319,,,,,16612,740138,21020,320319,37632,1060353
65,2021-02-17,20663,760801,26380.0,346699,,,,,20663,760801,26380,346699,47043,1107396
66,2021-02-18,3200,764001,4621.0,351320,,,,,3200,764001,4621,351320,7821,1115217
67,2021-02-19,10256,774257,19928.0,371248,,,,,10256,774257,19928,371248,30184,1145401
68,2021-02-20,10315,784572,20292.0,391540,,,,,10315,784572,20292,391540,30607,1176008
69,2021-02-21,6183,790755,7660.0,399200,,,,,6183,790755,7660,399200,13843,1189851
70,2021-02-22,8034,798789,15478.0,414678,,,,,8034,798789,15478,414678,23512,1213363
71,2021-02-23,15537,814326,15992.0,430670,,,,,15537,814326,15992,430670,31529,1244892
72,2021-02-24,17956,832282,24741.0,455411,,,,,17956,832282,24741,455411,42697,1287589
73,2021-02-25,20397,852679,26558.0,481969,,,,,20397,852679,26558,481969,46955,1334544
74,2021-02-26,26722,879401,26229.0,508198,,,,,26722,879401,26229,508198,52951,1387495
75,2021-02-27,16009,895410,11159.0,519357,,,,,16009,895410,11159,519357,27168,1414663
76,2021-02-28,15496,910906,4885.0,524242,,,,,15496,910906,4885,524242,20381,1435044
77,2021-03-01,27046,937952,12644.0,536886,,,,,27046,937952,12644,536886,39690,1474734
78,2021-03-02,23936,961888,13280.0,550166,,,35.0,35.0,23971,961923,13315,550201,37251,1511985
79,2021-03-03,30202,992090,18400.0,568566,,,188.0,223.0,30390,992313,18588,568789,48790,1560775
80,2021-03-04,30965,1023055,18211.0,586777,,,4068.0,4291.0,35033,1027346,22279,591068,53244,1614019
81,2021-03-05,30033,1053088,19729.0,606506,,,4909.0,9200.0,34942,1062288,24638,615706,54671,1668690
82,2021-03-06,18924,1072012,9512.0,616018,,,6010.0,15210.0,24934,1087222,15522,631228,34446,1703136
83,2021-03-07,12124,1084136,4865.0,620883,,,6609.0,21819.0,18733,1105955,11474,642702,23598,1726734
84,2021-03-08,25887,1110023,8854.0,629737,,,8273.0,30092.0,34160,1140115,17127,659829,43014,1769748
85,2021-03-09,26139,1136162,15473.0,645210,,,8342.0,38434.0,34481,1174596,23815,683644,49954,1819702
86,2021-03-10,29869,1166031,16007.0,661217,,,7939.0,46373.0,37808,1212404,23946,707590,53815,1873517
87,2021-03-11,35993,1202024,16406.0,677623,,,3981.0,50354.0,39974,1252378,20387,727977,56380,1929897
88,2021-03-12,36922,1238946,18091.0,695714,,,2927.0,53281.0,39849,1292227,21018,748995,57940,1987837
89,2021-03-13,22676,1261622,10290.0,706004,,,1629.0,54910.0,24305,1316532,11919,760914,34595,2022432
90,2021-03-14,17834,1279456,6720.0,712724,,,1007.0,55917.0,18841,1335373,7727,768641,25561,2047993
91,2021-03-15,29837,1309293,11308.0,724032,,,597.0,56514.0,30434,1365807,11905,780546,41742,2089735
92,2021-03-16,33422,1342715,13578.0,737610,,,770.0,57284.0,34192,1399999,14348,794894,47770,2137505
93,2021-03-17,37584,1380299,17062.0,754672,,,1181.0,58465.0,38765,1438764,18243,813137,55827,2193332
94,2021-03-18,41456,1421755,12659.0,767331,,,1348.0,59813.0,42804,1481568,14007,827144,55463,2248795
95,2021-03-19,38347,1460102,15423.0,782754,,,1044.0,60857.0,39391,1520959,16467,843611,54814,2303609
96,2021-03-20,24709,1484811,10169.0,792923,,,704.0,61561.0,25413,1546372,10873,854484,35582,2339191
97,2021-03-21,19185,1503996,7886.0,800809,,,337.0,61898.0,19522,1565894,8223,862707,27408,2366599
98,2021-03-22,32599,1536595,11487.0,812296,,,835.0,62733.0,33434,1599328,12322,875029,44921,2411520
99,2021-03-23,38422,1575017,17814.0,830110,,,1556.0,64289.0,39978,1639306,19370,894399,57792,2469312
100,2021-03-24,41097,1616114,21222.0,851332,,,1388.0,65677.0,42485,1681791,22610,917009,63707,2533019
101,2021-03-25,42900,1659014,21699.0,873031,,,2457.0,68134.0,45357,1727148,24156,941165,67056,2600075
102,2021-03-26,36381,1695395,26687.0,899718,,,2495.0,70629.0,38876,1766024,29182,970347,65563,2665638
103,2021-03-27,26477,1721872,17287.0,917005,,,2491.0,73120.0,28968,1794992,19778,990125,46255,2711893
104,2021-03-28,17016,1738888,12647.0,929652,,,1616.0,74736.0,18632,1813624,14263,1004388,31279,2743172
105,2021-03-29,29727,1768615,26299.0,955951,,,1143.0,75879.0,30870,1844494,27442,1031830,57169,2800341
106,2021-03-30,40064,1808679,29006.0,984957,,,1864.0,77743.0,41928,1886422,30870,1062700,70934,2871275
107,2021-03-31,41047,1849726,34699.0,1019656,,,5748.0,83491.0,46795,1933217,40447,1103147,81494,2952769
108,2021-04-01,42393,1892119,41049.0,1060705,,,5748.0,89239.0,48141,1981358,46797,1149944,89190,3041959
109,2021-04-02,34937,1927056,32677.0,1093382,,,6128.0,95367.0,41065,2022423,38805,1188749,73742,3115701
110,2021-04-03,21170,1948226,19192.0,1112574,,,4389.0,99756.0,25559,2047982,23581,1212330,44751,3160452
111,2021-04-04,8287,1956513,10189.0,1122763,,,968.0,100724.0,9255,2057237,11157,1223487,19444,3179896
112,2021-04-05,27970,1984483,28931.0,1151694,,,6658.0,107382.0,34628,2091865,35589,1259076,63559,3243455
113,2021-04-06,39784,2024267,30477.0,1182171,,,10494.0,117876.0,50278,2142143,40971,1300047,80755,3324210
114,2021-04-07,36098,2060365,34300.0,1216471,,,12989.0,130865.0,49087,2191230,47289,1347336,83387,3407597
115,2021-04-08,42340,2102705,36109.0,1252580,,,13863.0,144728.0,56203,2247433,49972,1397308,92312,3499909
116,2021-04-09,34062,2136767,36326.0,1288906,,,14528.0,159256.0,48590,2296023,50854,1448162,84916,3584825
117,2021-04-10,23473,2160240,23140.0,1312046,,,7640.0,166896.0,31113,2327136,30780,1478942,54253,3639078
118,2021-04-11,17567,2177807,13277.0,1325323,,,10119.0,177015.0,27686,2354822,23396,1502338,40963,3680041
119,2021-04-12,24609,2202416,33168.0,1358491,,,10896.0,187911.0,35505,2390327,44064,1546402,68673,3748714
120,2021-04-13,126198,2328614,91238.0,1449729,,,3293.0,191204.0,129491,2519818,94531,1640933,220729,3969443
121,2021-04-14,40722,2369336,37831.0,1487560,,,213.0,191417.0,40935,2560753,38044,1678977,78766,4048209
122,2021-04-15,41417,2410753,39560.0,1527120,,,176.0,191593.0,41593,2602346,39736,1718713,81153,4129362
123,2021-04-16,37151,2447904,38873.0,1565993,,,24.0,191617.0,37175,2639521,38897,1757610,76048,4205410
124,2021-04-17,32804,2480708,22031.0,1588024,,,12.0,191629.0,32816,2672337,22043,1779653,54847,4260257
125,2021-04-18,20068,2500776,16200.0,1604224,,,5.0,191634.0,20073,2692410,16205,1795858,36273,4296530
126,2021-04-19,29896,2530672,36548.0,1640772,,,61.0,191695.0,29957,2722367,36609,1832467,66505,4363035
127,2021-04-20,32938,2563610,44460.0,1685232,,,58.0,191753.0,32996,2755363,44518,1876985,77456,4440491
128,2021-04-21,39839,2603449,47062.0,1732294,,,26.0,191779.0,39865,2795228,47088,1924073,86927,4527418
129,2021-04-22,35868,2639317,42667.0,1774961,,,16.0,191795.0,35884,2831112,42683,1966756,78551,4605969
130,2021-04-23,33155,2672472,40154.0,1815115,,,14.0,191809.0,33169,2864281,40168,2006924,73323,4679292
131,2021-04-24,26417,2698889,27912.0,1843027,,,81.0,191890.0,26498,2890779,27993,2034917,54410,4733702
132,2021-04-25,20234,2719123,10976.0,1854003,,,31.0,191921.0,20265,2911044,11007,2045924,31241,4764943
133,2021-04-26,27414,2746537,32715.0,1886718,,,201.0,192122.0,27615,2938659,32916,2078840,60330,4825273
134,2021-04-27,26689,2773226,33080.0,1919798,,,1097.0,193219.0,27786,2966445,34177,2113017,60866,4886139
135,2021-04-28,28932,2802158,39546.0,1959344,,,1364.0,194583.0,30296,2996741,40910,2153927,69842,4955981
136,2021-04-29,27080,2829238,39748.0,1999092,,,1463.0,196046.0,28543,3025284,41211,2195138,68291,5024272
137,2021-04-30,28211,2857449,32277.0,2031369,,,1648.0,197694.0,29859,3055143,33925,2229063,62136,5086408
138,2021-05-01,20736,2878185,26702.0,2058071,,,1050.0,198744.0,21786,3076929,27752,2256815,48488,5134896
139,2021-05-02,10289,2888474,17044.0,2075115,,,822.0,199566.0,11111,3088040,17866,2274681,28155,5163051
140,2021-05-03,12752,2901226,28589.0,2103704,,,1915.0,201481.0,14667,3102707,30504,2305185,43256,5206307
141,2021-05-04,13569,2914795,38620.0,2142324,,,1739.0,203220.0,15308,3118015,40359,2345544,53928,5260235
142,2021-05-05,19326,2934121,37760.0,2180084,,,1921.0,205141.0,21247,3139262,39681,2385225,59007,5319242
143,2021-05-06,16921,2951042,40594.0,2220678,,,1722.0,206863.0,18643,3157905,42316,2427541,59237,5378479
144,2021-05-07,17590,2968632,37001.0,2257679,,,1959.0,208822.0,19549,3177454,38960,2466501,56550,5435029
145,2021-05-08,10795,2979427,31224.0,2288903,,,1291.0,210113.0,12086,3189540,32515,2499016,43310,5478339
146,2021-05-09,5085,2984512,12242.0,2301145,,,695.0,210808.0,5780,3195320,12937,2511953,18022,5496361
147,2021-05-10,8955,2993467,31051.0,2332196,,,1362.0,212170.0,10317,3205637,32413,2544366,41368,5537729
148,2021-05-11,12183,3005650,30285.0,2362481,,,1441.0,213611.0,13624,3219261,31726,2576092,43909,5581638
149,2021-05-12,13949,3019599,38622.0,2401103,,,1919.0,215530.0,15868,3235129,40541,2616633,54490,5636128
150,2021-05-13,21841,3041440,33514.0,2434617,,,1347.0,216877.0,23188,3258317,34861,2651494,56702,5692830
151,2021-05-14,24389,3065829,30059.0,2464676,,,1773.0,218650.0,26162,3284479,31832,2683326,56221,5749051
152,2021-05-15,21941,3087770,25109.0,2489785,,,1489.0,220139.0,23430,3307909,26598,2709924,48539,5797590
153,2021-05-16,9091,3096861,17585.0,2507370,,,1113.0,221252.0,10204,3318113,18698,2728622,27789,5825379
154,2021-05-17,16837,3113698,28411.0,2535781,,,1949.0,223201.0,18786,3336899,30360,2758982,47197,5872576
155,2021-05-18,21264,3134962,30689.0,2566470,,,1942.0,225143.0,23206,3360105,32631,2791613,53895,5926471
156,2021-05-19,27664,3162626,32435.0,2598905,,,1631.0,226774.0,29295,3389400,34066,2825679,61730,5988201
157,2021-05-20,20805,3183431,33278.0,2632183,,,1964.0,228738.0,22769,3412169,35242,2860921,56047,6044248
158,2021-05-21,19166,3202597,30354.0,2662537,,,1608.0,230346.0,20774,3432943,31962,2892883,51128,6095376
159,2021-05-22,16937,3219534,20695.0,2683232,,,1270.0,231616.0,18207,3451150,21965,2914848,38902,6134278
160,2021-05-23,8815,3228349,11448.0,2694680,,,965.0,232581.0,9780,3460930,12413,2927261,21228,6155506
161,2021-05-24,13568,3241917,17774.0,2712454,,,1474.0,234055.0,15042,3475972,19248,2946509,32816,6188322
162,2021-05-25,13072,3254989,18720.0,2731174,,,1329.0,235384.0,14401,3490373,20049,2966558,33121,6221443
163,2021-05-26,18314,3273303,19512.0,2750686,,,1512.0,236896.0,19826,3510199,21024,2987582,39338,6260781
164,2021-05-27,11687,3284990,18671.0,2769357,,,1116.0,238012.0,12803,3523002,19787,3007369,31474,6292255
165,2021-05-28,12419,3297409,19849.0,2789206,,,1401.0,239413.0,13820,3536822,21250,3028619,33669,6325924
166,2021-05-29,9516,3306925,11727.0,2800933,,,937.0,240350.0,10453,3547275,12664,3041283,22180,6348104
167,2021-05-30,4969,3311894,6434.0,2807367,,,596.0,240946.0,5565,3552840,7030,3048313,11999,6360103
168,2021-05-31,1779,3313673,3710.0,2811077,,,305.0,241251.0,2084,3554924,4015,3052328,5794,6365897
169,2021-06-01,9855,3323528,16443.0,2827520,,,1160.0,242411.0,11015,3565939,17603,3069931,27458,6393355
170,2021-06-02,10233,3333761,16821.0,2844341,,,960.0,243371.0,11193,3577132,17781,3087712,28014,6421369
171,2021-06-03,7899,3341660,21187.0,2865528,,,1087.0,244458.0,8986,3586118,22274,3109986,30173,6451542
172,2021-06-04,8198,3349858,22353.0,2887881,,,1120.0,245578.0,9318,3595436,23473,3133459,31671,6483213
173,2021-06-05,7001,3356859,19471.0,2907352,,,720.0,246298.0,7721,3603157,20191,3153650,27192,6510405
174,2021-06-06,3454,3360313,7253.0,2914605,,,423.0,246721.0,3877,3607034,7676,3161326,11130,6521535
175,2021-06-07,6857,3367170,15789.0,2930394,,,726.0,247447.0,7583,3614617,16515,3177841,23372,6544907
176,2021-06-08,6669,3373839,19735.0,2950129,,,830.0,248277.0,7499,3622116,20565,3198406,27234,6572141
177,2021-06-09,8200,3382039,23988.0,2974117,,,968.0,249245.0,9168,3631284,24956,3223362,33156,6605297
178,2021-06-10,7151,3389190,19139.0,2993256,,,895.0,250140.0,8046,3639330,20034,3243396,27185,6632482
179,2021-06-11,7487,3396677,17725.0,3010981,,,1125.0,251265.0,8612,3647942,18850,3262246,26337,6658819
180,2021-06-12,5241,3401918,14768.0,3025749,,,605.0,251870.0,5846,3653788,15373,3277619,20614,6679433
181,2021-06-13,1936,3403854,7633.0,3033382,,,427.0,252297.0,2363,3656151,8060,3285679,9996,6689429
182,2021-06-14,5656,3409510,11816.0,3045198,,,733.0,253030.0,6389,3662540,12549,3298228,18205,6707634
183,2021-06-15,5646,3415156,14341.0,3059539,,,873.0,253903.0,6519,3669059,15214,3313442,20860,6728494
184,2021-06-16,8757,3423913,21594.0,3081133,,,757.0,254660.0,9514,3678573,22351,3335793,31108,6759602
185,2021-06-17,6689,3430602,12367.0,3093500,,,720.0,255380.0,7409,3685982,13087,3348880,19776,6779378
186,2021-06-18,6835,3437437,12742.0,3106242,,,703.0,256083.0,7538,3693520,13445,3362325,20280,6799658
187,2021-06-19,4660,3442097,9382.0,3115624,,,615.0,256698.0,5275,3698795,9997,3372322,14657,6814315
188,2021-06-20,2504,3444601,5059.0,3120683,,,377.0,257075.0,2881,3701676,5436,3377758,7940,6822255
189,2021-06-21,5565,3450166,5338.0,3126021,,,635.0,257710.0,6200,3707876,5973,3383731,11538,6833793
190,2021-06-22,5346,3455512,9053.0,3135074,,,693.0,258403.0,6039,3713915,9746,3393477,15092,6848885
191,2021-06-23,6077,3461589,10336.0,3145410,,,646.0,259049.0,6723,3720638,10982,3404459,17059,6865944
192,2021-06-24,5937,3467526,8201.0,3153611,,,595.0,259644.0,6532,3727170,8796,3413255,14733,6880677
193,2021-06-25,5828,3473354,8667.0,3162278,,,620.0,260264.0,6448,3733618,9287,3422542,15115,6895792
194,2021-06-26,3704,3477058,6308.0,3168586,,,398.0,260662.0,4102,3737720,6706,3429248,10410,6906202
195,2021-06-27,2808,3479866,3524.0,3172110,,,185.0,260847.0,2993,3740713,3709,3432957,6517,6912719
196,2021-06-28,4920,3484786,6388.0,3178498,,,539.0,261386.0,5459,3746172,6927,3439884,11847,6924566
197,2021-06-29,5063,3489849,6476.0,3184974,,,519.0,261905.0,5582,3751754,6995,3446879,12058,6936624
198,2021-06-30,5626,3495475,7388.0,3192362,,,605.0,262510.0,6231,3757985,7993,3454872,13619,6950243
199,2021-07-01,5416,3500891,6989.0,3199351,,,500.0,263010.0,5916,3763901,7489,3462361,12905,6963148
200,2021-07-02,5293,3506184,6842.0,3206193,,,524.0,263534.0,5817,3769718,7366,3469727,12659,6975807
201,2021-07-03,3271,3509455,4067.0,3210260,,,264.0,263798.0,3535,3773253,4331,3474058,7602,6983409
202,2021-07-04,494,3509949,549.0,3210809,,,68.0,263866.0,562,3773815,617,3474675,1111,6984520
203,2021-07-05,3768,3513717,3955.0,3214764,,,287.0,264153.0,4055,3777870,4242,3478917,8010,6992530
204,2021-07-06,4492,3518209,6272.0,3221036,,,454.0,264607.0,4946,3782816,6726,3485643,11218,7003748
205,2021-07-07,4468,3522677,6413.0,3227449,,,482.0,265089.0,4950,3787766,6895,3492538,11363,7015111
206,2021-07-08,4838,3527515,6177.0,3233626,,,564.0,265653.0,5402,3793168,6741,3499279,11579,7026690
207,2021-07-09,5369,3532884,6667.0,3240293,,,573.0,266226.0,5942,3799110,7240,3506519,12609,7039299
208,2021-07-10,3520,3536404,4406.0,3244699,,,304.0,266530.0,3824,3802934,4710,3511229,8230,7047529
209,2021-07-11,2678,3539082,2574.0,3247273,,,226.0,266756.0,2904,3805838,2800,3514029,5478,7053007
210,2021-07-12,4422,3543504,5130.0,3252403,,,379.0,267135.0,4801,3810639,5509,3519538,9931,7062938
211,2021-07-13,4665,3548169,4721.0,3257124,,,366.0,267501.0,5031,3815670,5087,3524625,9752,7072690
212,2021-07-14,4623,3552792,5285.0,3262409,,,422.0,267923.0,5045,3820715,5707,3530332,10330,7083020
213,2021-07-15,4907,3557699,5015.0,3267424,,,359.0,268282.0,5266,3825981,5374,3535706,10281,7093301
214,2021-07-16,6275,3563974,5847.0,3273271,,,405.0,268687.0,6680,3832661,6252,3541958,12527,7105828
215,2021-07-17,3416,3567390,3551.0,3276822,,,303.0,268990.0,3719,3836380,3854,3545812,7270,7113098
216,2021-07-18,2309,3569699,2379.0,3279201,,,110.0,269100.0,2419,3838799,2489,3548301,4798,7117896
217,2021-07-19,5143,3574842,4611.0,3283812,,,383.0,269483.0,5526,3844325,4994,3553295,10137,7128033
218,2021-07-20,5339,3580181,4716.0,3288528,,,366.0,269849.0,5705,3850030,5082,3558377,10421,7138454
219,2021-07-21,5664,3585845,4945.0,3293473,,,416.0,270265.0,6080,3856110,5361,3563738,11025,7149479
220,2021-07-22,6029,3591874,4640.0,3298113,,,472.0,270737.0,6501,3862611,5112,3568850,11141,7160620
221,2021-07-23,6845,3598719,4846.0,3302959,,,498.0,271235.0,7343,3869954,5344,3574194,12189,7172809
222,2021-07-24,4284,3603003,3200.0,3306159,,,267.0,271502.0,4551,3874505,3467,3577661,7751,7180560
223,2021-07-25,3298,3606301,1120.0,3307279,,,140.0,271642.0,3438,3877943,1260,3578921,4558,7185118
224,2021-07-26,6217,3612518,3908.0,3311187,,,419.0,272061.0,6636,3884579,4327,3583248,10544,7195662
225,2021-07-27,6603,3619121,4285.0,3315472,,,458.0,272519.0,7061,3891640,4743,3587991,11346,7207008
226,2021-07-28,7085,3626206,4145.0,3319617,,,460.0,272979.0,7545,3899185,4605,3592596,11690,7218698
227,2021-07-29,7080,3633286,4302.0,3323919,,,419.0,273398.0,7499,3906684,4721,3597317,11801,7230499
228,2021-07-30,7820,3641106,4810.0,3328729,,,526.0,273924.0,8346,3915030,5336,3602653,13156,7243655
229,2021-07-31,4793,3645899,3078.0,3331807,,,274.0,274198.0,5067,3920097,3352,3606005,8145,7251800
230,2021-08-01,3890,3649789,2166.0,3333973,159.0,159.0,163.0,274361.0,4053,3924150,2329,3608334,6378,7258178
231,2021-08-02,7271,3657060,3843.0,3337816,125.0,284.0,341.0,274702.0,7612,3931762,4184,3612518,11580,7269758
232,2021-08-03,7269,3664329,4106.0,3341922,88.0,372.0,517.0,275219.0,7786,3939548,4623,3617141,11980,7281738
233,2021-08-04,7423,3671752,4121.0,3346043,97.0,469.0,535.0,275754.0,7958,3947506,4656,3621797,12176,7293914
234,2021-08-05,7945,3679697,4298.0,3350341,96.0,565.0,538.0,276292.0,8483,3955989,4836,3626633,12877,7306791
235,2021-08-06,8323,3688020,4736.0,3355077,122.0,687.0,454.0,276746.0,8777,3964766,5190,3631823,13635,7320426
236,2021-08-07,5303,3693323,2840.0,3357917,90.0,777.0,264.0,277010.0,5567,3970333,3104,3634927,8497,7328923
237,2021-08-08,3974,3697297,2062.0,3359979,65.0,842.0,144.0,277154.0,4118,3974451,2206,3637133,6245,7335168
238,2021-08-09,6955,3704252,4558.0,3364537,97.0,939.0,369.0,277523.0,7324,3981775,4927,3642060,11979,7347147
239,2021-08-10,7161,3711413,4479.0,3369016,107.0,1046.0,339.0,277862.0,7500,3989275,4818,3646878,12086,7359233
240,2021-08-11,7077,3718490,4448.0,3373464,103.0,1149.0,443.0,278305.0,7520,3996795,4891,3651769,12071,7371304
241,2021-08-12,8625,3727115,4754.0,3378218,148.0,1297.0,445.0,278750.0,9070,4005865,5199,3656968,13972,7385276
242,2021-08-13,7143,3734258,5379.0,3383597,192.0,1489.0,397.0,279147.0,7540,4013405,5776,3662744,13111,7398387
243,2021-08-14,4915,3739173,3347.0,3386944,674.0,2163.0,285.0,279432.0,5200,4018605,3632,3666376,9221,7407608
244,2021-08-15,3328,3742501,2740.0,3389684,569.0,2732.0,163.0,279595.0,3491,4022096,2903,3669279,6800,7414408
245,2021-08-16,5442,3747943,5097.0,3394781,1242.0,3974.0,354.0,279949.0,5796,4027892,5451,3674730,12135,7426543
246,2021-08-17,6813,3754756,5362.0,3400143,1437.0,5411.0,390.0,280339.0,7203,4035095,5752,3680482,14002,7440545
247,2021-08-18,6326,3761082,5506.0,3405649,1623.0,7034.0,481.0,280820.0,6807,4041902,5987,3686469,13936,7454481
248,2021-08-19,6213,3767295,5555.0,3411204,1627.0,8661.0,417.0,281237.0,6630,4048532,5972,3692441,13812,7468293
249,2021-08-20,6839,3774134,6550.0,3417754,1717.0,10378.0,401.0,281638.0,7240,4055772,6951,3699392,15507,7483800
250,2021-08-21,4327,3778461,3919.0,3421673,870.0,11248.0,230.0,281868.0,4557,4060329,4149,3703541,9346,7493146
251,2021-08-22,3060,3781521,3173.0,3424846,801.0,12049.0,110.0,281978.0,3170,4063499,3283,3706824,7144,7500290
252,2021-08-23,5986,3787507,6099.0,3430945,1799.0,13848.0,287.0,282265.0,6273,4069772,6386,3713210,14171,7514461
253,2021-08-24,6545,3794052,6064.0,3437009,1726.0,15574.0,425.0,282690.0,6970,4076742,6489,3719699,14760,7529221
254,2021-08-25,6717,3800769,6222.0,3443231,1580.0,17154.0,441.0,283131.0,7158,4083900,6663,3726362,14960,7544181
255,2021-08-26,6965,3807734,6650.0,3449881,1718.0,18872.0,428.0,283559.0,7393,4091293,7078,3733440,15761,7559942
256,2021-08-27,6825,3814559,7072.0,3456953,2002.0,20874.0,316.0,283875.0,7141,4098434,7388,3740828,16215,7576157
257,2021-08-28,6895,3821454,6522.0,3463475,999.0,21873.0,326.0,284201.0,7221,4105655,6848,3747676,14742,7590899
258,2021-08-29,3733,3825187,3689.0,3467164,675.0,22548.0,610.0,284811.0,4343,4109998,4299,3751975,8707,7599606
259,2021-08-30,5923,3831110,6127.0,3473291,1530.0,24078.0,960.0,285771.0,6883,4116881,7087,3759062,14540,7614146
260,2021-08-31,5899,3837009,6070.0,3479361,1651.0,25729.0,946.0,286717.0,6845,4123726,7016,3766078,14566,7628712
261,2021-09-01,5589,3842598,5675.0,3485036,1714.0,27443.0,915.0,287632.0,6504,4130230,6590,3772668,13893,7642605
262,2021-09-02,5529,3848127,5925.0,3490961,1852.0,29295.0,707.0,288339.0,6236,4136466,6632,3779300,14013,7656618
263,2021-09-03,5992,3854119,6930.0,3497891,1829.0,31124.0,973.0,289312.0,6965,4143431,7903,3787203,15724,7672342
264,2021-09-04,3726,3857845,4352.0,3502243,869.0,31993.0,878.0,290190.0,4604,4148035,5230,3792433,9825,7682167
265,2021-09-05,2956,3860801,2809.0,3505052,653.0,32646.0,106.0,290296.0,3062,4151097,2915,3795348,6524,7688691
266,2021-09-06,1059,3861860,1156.0,3506208,213.0,32859.0,65.0,290361.0,1124,4152221,1221,3796569,2493,7691184
267,2021-09-07,5343,3867203,7299.0,3513507,1411.0,34270.0,2303.0,292664.0,7646,4159867,9602,3806171,16356,7707540
268,2021-09-08,4653,3871856,5475.0,3518982,1561.0,35831.0,364.0,293028.0,5017,4164884,5839,3812010,12053,7719593
269,2021-09-09,5017,3876873,5458.0,3524440,2272.0,38103.0,324.0,293352.0,5341,4170225,5782,3817792,13071,7732664
270,2021-09-10,6519,3883392,6655.0,3531095,2459.0,40562.0,1719.0,295071.0,8238,4178463,8374,3826166,17352,7750016
271,2021-09-11,4173,3887565,4334.0,3535429,1011.0,41573.0,666.0,295737.0,4839,4183302,5000,3831166,10184,7760200
272,2021-09-12,3172,3890737,3241.0,3538670,693.0,42266.0,436.0,296173.0,3608,4186910,3677,3834843,7542,7767742
273,2021-09-13,4885,3895622,5067.0,3543737,1522.0,43788.0,346.0,296519.0,5231,4192141,5413,3840256,11820,7779562
274,2021-09-14,4776,3900398,5437.0,3549174,1588.0,45376.0,436.0,296955.0,5212,4197353,5873,3846129,12237,7791799
275,2021-09-15,5039,3905437,5870.0,3555044,1468.0,46844.0,392.0,297347.0,5431,4202784,6262,3852391,12769,7804568
276,2021-09-16,4808,3910245,5844.0,3560888,1598.0,48442.0,336.0,297683.0,5144,4207928,6180,3858571,12586,7817154
277,2021-09-17,5258,3915503,6584.0,3567472,1916.0,50358.0,344.0,298027.0,5602,4213530,6928,3865499,14102,7831256
278,2021-09-18,3801,3919304,4577.0,3572049,925.0,51283.0,185.0,298212.0,3986,4217516,4762,3870261,9488,7840744
279,2021-09-19,2741,3922045,3167.0,3575216,690.0,51973.0,75.0,298287.0,2816,4220332,3242,3873503,6673,7847417
280,2021-09-20,3750,3925795,4680.0,3579896,1730.0,53703.0,430.0,298717.0,4180,4224512,5110,3878613,10590,7858007
281,2021-09-21,4002,3929797,5001.0,3584897,1844.0,55547.0,327.0,299044.0,4329,4228841,5328,3883941,11174,7869181
282,2021-09-22,4196,3933993,4775.0,3589672,1734.0,57281.0,458.0,299502.0,4654,4233495,5233,3889174,11163,7880344
283,2021-09-23,4175,3938168,4731.0,3594403,2169.0,59450.0,492.0,299994.0,4667,4238162,5223,3894397,11567,7891911
284,2021-09-24,5078,3943246,5606.0,3600009,4821.0,64271.0,422.0,300416.0,5500,4243662,6028,3900425,15927,7907838
285,2021-09-25,3626,3946872,3632.0,3603641,4914.0,69185.0,384.0,300800.0,4010,4247672,4016,3904441,12556,7920394
286,2021-09-26,2354,3949226,2667.0,3606308,3062.0,72247.0,425.0,301225.0,2779,4250451,3092,3907533,8508,7928902
287,2021-09-27,4506,3953732,2712.0,3609020,8855.0,81102.0,512.0,301737.0,5018,4255469,3224,3910757,16585,7945487
288,2021-09-28,4400,3958132,4455.0,3613475,9437.0,90539.0,211.0,301948.0,4611,4260080,4666,3915423,18503,7963990
289,2021-09-29,4696,3962828,4511.0,3617986,9818.0,100357.0,920.0,302868.0,5616,4265696,5431,3920854,19945,7983935
290,2021-09-30,4887,3967715,4566.0,3622552,9935.0,110292.0,795.0,303663.0,5682,4271378,5361,3926215,20183,8004118
291,2021-10-01,5503,3973218,5340.0,3627892,11866.0,122158.0,785.0,304448.0,6288,4277666,6125,3932340,23494,8027612
292,2021-10-02,2937,3976155,2897.0,3630789,5759.0,127917.0,187.0,304635.0,3124,4280790,3084,3935424,11780,8039392
293,2021-10-03,2073,3978228,2378.0,3633167,3456.0,131373.0,86.0,304721.0,2159,4282949,2464,3937888,7993,8047385
294,2021-10-04,4022,3982250,3501.0,3636668,9812.0,141185.0,232.0,304953.0,4254,4287203,3733,3941621,17567,8064952
295,2021-10-05,3958,3986208,3661.0,3640329,10148.0,151333.0,207.0,305160.0,4165,4291368,3868,3945489,17974,8082926
296,2021-10-06,4023,3990231,3579.0,3643908,8928.0,160261.0,266.0,305426.0,4289,4295657,3845,3949334,16796,8099722
297,2021-10-07,4234,3994465,3627.0,3647535,9925.0,170186.0,331.0,305757.0,4565,4300222,3958,3953292,18117,8117839
298,2021-10-08,4770,3999235,4290.0,3651825,11367.0,181553.0,283.0,306040.0,5053,4305275,4573,3957865,20710,8138549
299,2021-10-09,2691,4001926,2682.0,3654507,4300.0,185853.0,270.0,306310.0,2961,4308236,2952,3960817,9943,8148492
300,2021-10-10,1865,4003791,1850.0,3656357,3575.0,189428.0,59.0,306369.0,1924,4310160,1909,3962726,7349,8155841
301,2021-10-11,4213,4008004,3338.0,3659695,9206.0,198634.0,249.0,306618.0,4462,4314622,3587,3966313,17006,8172847
302,2021-10-12,3590,4011594,3525.0,3663220,9565.0,208199.0,273.0,306891.0,3863,4318485,3798,3970111,16953,8189800
303,2021-10-13,3959,4015553,3458.0,3666678,8749.0,216948.0,346.0,307237.0,4305,4322790,3804,3973915,16512,8206312
304,2021-10-14,5161,4020714,5492.0,3672170,9518.0,226466.0,431.0,307668.0,5592,4328382,5923,3979838,20602,8226914
305,2021-10-15,4710,4025424,4596.0,3676766,10620.0,237086.0,347.0,308015.0,5057,4333439,4943,3984781,20273,8247187
306,2021-10-16,2496,4027920,2507.0,3679273,4670.0,241756.0,291.0,308306.0,2787,4336226,2798,3987579,9964,8257151
307,2021-10-17,1806,4029726,1776.0,3681049,2780.0,244536.0,55.0,308361.0,1861,4338087,1831,3989410,6417,8263568
308,2021-10-18,4283,4034009,3581.0,3684630,9212.0,253748.0,268.0,308629.0,4551,4342638,3849,3993259,17344,8280912
309,2021-10-19,4301,4038310,4031.0,3688661,9546.0,263294.0,223.0,308852.0,4524,4347162,4254,3997513,18101,8299013
310,2021-10-20,3526,4041836,3427.0,3692088,8989.0,272283.0,255.0,309107.0,3781,4350943,3682,4001195,16197,8315210
311,2021-10-21,3298,4045134,3270.0,3695358,9934.0,282217.0,291.0,309398.0,3589,4354532,3561,4004756,16793,8332003
312,2021-10-22,4681,4049815,4034.0,3699392,18776.0,300993.0,477.0,309875.0,5158,4359690,4511,4009267,27968,8359971
313,2021-10-23,2886,4052701,2115.0,3701507,11079.0,312072.0,321.0,310196.0,3207,4362897,2436,4011703,16401,8376372
314,2021-10-24,2057,4054758,1560.0,3703067,7178.0,319250.0,79.0,310275.0,2136,4365033,1639,4013342,10874,8387246
315,2021-10-25,4541,4059299,3082.0,3706149,23250.0,342500.0,319.0,310594.0,4860,4369893,3401,4016743,31192,8418438
316,2021-10-26,4506,4063805,3095.0,3709244,25464.0,367964.0,316.0,310910.0,4822,4374715,3411,4020154,33381,8451819
317,2021-10-27,4734,4068539,3345.0,3712589,25591.0,393555.0,437.0,311347.0,5171,4379886,3782,4023936,34107,8485926
318,2021-10-28,4559,4073098,3365.0,3715954,26436.0,419991.0,501.0,311848.0,5060,4384946,3866,4027802,34861,8520787
319,2021-10-29,4979,4078077,3921.0,3719875,26358.0,446349.0,394.0,312242.0,5373,4390319,4315,4032117,35652,8556439
320,2021-10-30,2632,4080709,1844.0,3721719,13681.0,460030.0,308.0,312550.0,2940,4393259,2152,4034269,18465,8574904
321,2021-10-31,1938,4082647,1522.0,3723241,7813.0,467843.0,93.0,312643.0,2031,4395290,1615,4035884,11366,8586270
322,2021-11-01,4709,4087356,3437.0,3726678,25666.0,493509.0,346.0,312989.0,5055,4400345,3783,4039667,34158,8620428
323,2021-11-02,4255,4091611,2956.0,3729634,25969.0,519478.0,408.0,313397.0,4663,4405008,3364,4043031,33588,8654016
324,2021-11-03,4665,4096276,3062.0,3732696,26015.0,545493.0,463.0,313860.0,5128,4410136,3525,4046556,34205,8688221
325,2021-11-04,6312,4102588,3368.0,3736064,27049.0,572542.0,513.0,314373.0,6825,4416961,3881,4050437,37242,8725463
326,2021-11-05,8238,4110826,3773.0,3739837,28054.0,600596.0,414.0,314787.0,8652,4425613,4187,4054624,40479,8765942
327,2021-11-06,10185,4121011,1979.0,3741816,12934.0,613530.0,308.0,315095.0,10493,4436106,2287,4056911,25406,8791348
328,2021-11-07,7732,4128743,1468.0,3743284,7341.0,620871.0,94.0,315189.0,7826,4443932,1562,4058473,16635,8807983
329,2021-11-08,11309,4140052,3050.0,3746334,19592.0,640463.0,379.0,315568.0,11688,4455620,3429,4061902,34330,8842313
330,2021-11-09,11763,4151815,2665.0,3748999,23106.0,663569.0,269.0,315837.0,12032,4467652,2934,4064836,37803,8880116
331,2021-11-10,12585,4164400,2762.0,3751761,23753.0,687322.0,338.0,316175.0,12923,4480575,3100,4067936,39438,8919554
332,2021-11-11,11373,4175773,2382.0,3754143,22094.0,709416.0,280.0,316455.0,11653,4492228,2662,4070598,36129,8955683
333,2021-11-12,12290,4188063,3360.0,3757503,26221.0,735637.0,548.0,317003.0,12838,4505066,3908,4074506,42419,8998102
334,2021-11-13,9886,4197949,1593.0,3759096,12381.0,748018.0,342.0,317345.0,10228,4515294,1935,4076441,24202,9022304
335,2021-11-14,3922,4201871,1131.0,3760227,7283.0,755301.0,121.0,317466.0,4043,4519337,1252,4077693,12457,9034761
336,2021-11-15,8622,4210493,2529.0,3762756,20862.0,776163.0,205.0,317671.0,8827,4528164,2734,4080427,32218,9066979
337,2021-11-16,9227,4219720,2502.0,3765258,23196.0,799359.0,255.0,317926.0,9482,4537646,2757,4083184,35180,9102159
338,2021-11-17,9399,4229119,2880.0,3768138,22796.0,822155.0,312.0,318238.0,9711,4547357,3192,4086376,35387,9137546
339,2021-11-18,9290,4238409,2637.0,3770775,22828.0,844983.0,482.0,318720.0,9772,4557129,3119,4089495,35237,9172783
340,2021-11-19,9795,4248204,2921.0,3773696,27795.0,872778.0,381.0,319101.0,10176,4567305,3302,4092797,40892,9213675
341,2021-11-20,10627,4258831,1608.0,3775304,14534.0,887312.0,455.0,319556.0,11082,4578387,2063,4094860,27224,9240899
342,2021-11-21,4343,4263174,1203.0,3776507,9933.0,897245.0,99.0,319655.0,4442,4582829,1302,4096162,15578,9256477
343,2021-11-22,9824,4272998,2489.0,3778996,24941.0,922186.0,293.0,319948.0,10117,4592946,2782,4098944,37547,9294024
344,2021-11-23,9206,4282204,2401.0,3781397,25155.0,947341.0,280.0,320228.0,9486,4602432,2681,4101625,37042,9331066
345,2021-11-24,8156,4290360,2447.0,3783844,20333.0,967674.0,216.0,320444.0,8372,4610804,2663,4104288,31152,9362218
346,2021-11-25,239,4290599,77.0,3783921,609.0,968283.0,10.0,320454.0,249,4611053,87,4104375,935,9363153
347,2021-11-26,5652,4296251,3959.0,3787880,15995.0,984278.0,153.0,320607.0,5805,4616858,4112,4108487,25759,9388912
348,2021-11-27,3783,4300034,5475.0,3793355,11251.0,995529.0,134.0,320741.0,3917,4620775,5609,4114096,20643,9409555
349,2021-11-28,2414,4302448,6392.0,3799747,7699.0,1003228.0,77.0,320818.0,2491,4623266,6469,4120565,16582,9426137
350,2021-11-29,6370,4308818,9285.0,3809032,19114.0,1022342.0,379.0,321197.0,6749,4630015,9664,4130229,35148,9461285
351,2021-11-30,6253,4315071,9314.0,3818346,23191.0,1045533.0,264.0,321461.0,6517,4636532,9578,4139807,39022,9500307
352,2021-12-01,7284,4322355,9711.0,3828057,25787.0,1071320.0,308.0,321769.0,7592,4644124,10019,4149826,43090,9543397
353,2021-12-02,6910,4329265,8791.0,3836848,27401.0,1098721.0,451.0,322220.0,7361,4651485,9242,4159068,43553,9586950
354,2021-12-03,7596,4336861,9256.0,3846104,30843.0,1129564.0,249.0,322469.0,7845,4659330,9505,4168573,47944,9634894
355,2021-12-04,5949,4342810,10040.0,3856144,17178.0,1146742.0,465.0,322934.0,6414,4665744,10505,4179078,33632,9668526
356,2021-12-05,3469,4346279,3287.0,3859431,9917.0,1156659.0,78.0,323012.0,3547,4669291,3365,4182443,16751,9685277
357,2021-12-06,6751,4353030,7110.0,3866541,24753.0,1181412.0,277.0,323289.0,7028,4676319,7387,4189830,38891,9724168
358,2021-12-07,6410,4359440,7027.0,3873568,25862.0,1207274.0,249.0,323538.0,6659,4682978,7276,4197106,39548,9763716
359,2021-12-08,6931,4366371,7423.0,3880991,25028.0,1232302.0,315.0,323853.0,7246,4690224,7738,4204844,39697,9803413
360,2021-12-09,6528,4372899,7036.0,3888027,25790.0,1258092.0,398.0,324251.0,6926,4697150,7434,4212278,39752,9843165
361,2021-12-10,7272,4380171,7334.0,3895361,27223.0,1285315.0,230.0,324481.0,7502,4704652,7564,4219842,42059,9885224
362,2021-12-11,4455,4384626,7668.0,3903029,14771.0,1300086.0,333.0,324814.0,4788,4709440,8001,4227843,27227,9912451
363,2021-12-12,4002,4388628,2782.0,3905811,8122.0,1308208.0,60.0,324874.0,4062,4713502,2842,4230685,14966,9927417
364,2021-12-13,5696,4394324,5763.0,3911574,22561.0,1330769.0,243.0,325117.0,5939,4719441,6006,4236691,34263,9961680
365,2021-12-14,6454,4400778,5933.0,3917507,24041.0,1354810.0,221.0,325338.0,6675,4726116,6154,4242845,36649,9998329
366,2021-12-15,7140,4407918,5686.0,3923193,22326.0,1377136.0,251.0,325589.0,7391,4733507,5937,4248782,35403,10033732
367,2021-12-16,7850,4415768,2817.0,3926010,25722.0,1402858.0,420.0,326009.0,8270,4741777,3237,4252019,36809,10070541
368,2021-12-17,7808,4423576,4155.0,3930165,26925.0,1429783.0,195.0,326204.0,8003,4749780,4350,4256369,39083,10109624
369,2021-12-18,5824,4429400,3187.0,3933352,15795.0,1445578.0,298.0,326502.0,6122,4755902,3485,4259854,25104,10134728
370,2021-12-19,3379,4432779,1344.0,3934696,9793.0,1455371.0,36.0,326538.0,3415,4759317,1380,4261234,14552,10149280
371,2021-12-20,8063,4440842,3754.0,3938450,27061.0,1482432.0,173.0,326711.0,8236,4767553,3927,4265161,39051,10188331
372,2021-12-21,8993,4449835,4162.0,3942612,27584.0,1510016.0,175.0,326886.0,9168,4776721,4337,4269498,40914,10229245
373,2021-12-22,8678,4458513,3867.0,3946479,27696.0,1537712.0,184.0,327070.0,8862,4785583,4051,4273549,40425,10269670
374,2021-12-23,8397,4466910,3559.0,3950038,23385.0,1561097.0,359.0,327429.0,8756,4794339,3918,4277467,35700,10305370
375,2021-12-24,1634,4468544,1006.0,3951044,4731.0,1565828.0,39.0,327468.0,1673,4796012,1045,4278512,7410,10312780
376,2021-12-25,50,4468594,36.0,3951080,293.0,1566121.0,1.0,327469.0,51,4796063,37,4278549,380,10313160
377,2021-12-26,2519,4471113,1747.0,3952827,7075.0,1573196.0,44.0,327513.0,2563,4798626,1791,4280340,11385,10324545
378,2021-12-27,7195,4478308,3995.0,3956822,20979.0,1594175.0,297.0,327810.0,7492,4806118,4292,4284632,32466,10357011
379,2021-12-28,7890,4486198,3845.0,3960667,23934.0,1618109.0,177.0,327987.0,8067,4814185,4022,4288654,35846,10392857
380,2021-12-29,8210,4494408,4023.0,3964690,22632.0,1640741.0,155.0,328142.0,8365,4822550,4178,4292832,35020,10427877
381,2021-12-30,7467,4501875,3781.0,3968471,21213.0,1661954.0,289.0,328431.0,7756,4830306,4070,4296902,32750,10460627
382,2021-12-31,2571,4504446,1525.0,3969996,7246.0,1669200.0,90.0,328521.0,2661,4832967,1615,4298517,11432,10472059
383,2022-01-01,737,4505183,345.0,3970341,1760.0,1670960.0,33.0,328554.0,770,4833737,378,4298895,2875,10474934
384,2022-01-02,2210,4507393,1646.0,3971987,5474.0,1676434.0,47.0,328601.0,2257,4835994,1693,4300588,9377,10484311
385,2022-01-03,3393,4510786,2067.0,3974054,10646.0,1687080.0,221.0,328822.0,3614,4839608,2288,4302876,16327,10500638
386,2022-01-04,5841,4516627,3471.0,3977525,15748.0,1702828.0,162.0,328984.0,6003,4845611,3633,4306509,25222,10525860
387,2022-01-05,6827,4523454,4690.0,3982215,17837.0,1720665.0,176.0,329160.0,7003,4852614,4866,4311375,29530,10555390
388,2022-01-06,6748,4530202,4807.0,3987022,21879.0,1742544.0,264.0,329424.0,7012,4859626,5071,4316446,33698,10589088
389,2022-01-07,5957,4536159,3753.0,3990775,19100.0,1761644.0,159.0,329583.0,6116,4865742,3912,4320358,28969,10618057
390,2022-01-08,4804,4540963,3910.0,3994685,13090.0,1774734.0,79.0,329662.0,4883,4870625,3989,4324347,21883,10639940
391,2022-01-09,2758,4543721,2016.0,3996701,7472.0,1782206.0,154.0,329816.0,2912,4873537,2170,4326517,12400,10652340
392,2022-01-10,6310,4550031,3838.0,4000539,18483.0,1800689.0,156.0,329972.0,6466,4880003,3994,4330511,28787,10681127
393,2022-01-11,6539,4556570,4242.0,4004781,17812.0,1818501.0,142.0,330114.0,6681,4886684,4384,4334895,28735,10709862
394,2022-01-12,6804,4563374,4451.0,4009232,18263.0,1836764.0,225.0,330339.0,7029,4893713,4676,4339571,29743,10739605
395,2022-01-13,6604,4569978,4376.0,4013608,17093.0,1853857.0,150.0,330489.0,6754,4900467,4526,4344097,28223,10767828
396,2022-01-14,7199,4577177,3274.0,4016882,21612.0,1875469.0,252.0,330741.0,7451,4907918,3526,4347623,32337,10800165
397,2022-01-15,4265,4581442,1685.0,4018567,11428.0,1886897.0,70.0,330811.0,4335,4912253,1755,4349378,17448,10817613
398,2022-01-16,2216,4583658,1318.0,4019885,6163.0,1893060.0,116.0,330927.0,2332,4914585,1434,4350812,9813,10827426
399,2022-01-17,3609,4587267,2365.0,4022250,10026.0,1903086.0,74.0,331001.0,3683,4918268,2439,4353251,16074,10843500
400,2022-01-18,5267,4592534,4175.0,4026425,13048.0,1916134.0,102.0,331103.0,5369,4923637,4277,4357528,22592,10866092
401,2022-01-19,5278,4597812,4462.0,4030887,13041.0,1929175.0,99.0,331202.0,5377,4929014,4561,4362089,22880,10888972
402,2022-01-20,4520,4602332,3598.0,4034485,11599.0,1940774.0,176.0,331378.0,4696,4933710,3774,4365863,19893,10908865
403,2022-01-21,5575,4607907,2921.0,4037406,14744.0,1955518.0,126.0,331504.0,5701,4939411,3047,4368910,23366,10932231
404,2022-01-22,3448,4611355,1722.0,4039128,8834.0,1964352.0,134.0,331638.0,3582,4942993,1856,4370766,14138,10946369
405,2022-01-23,2033,4613388,1489.0,4040617,5700.0,1970052.0,30.0,331668.0,2063,4945056,1519,4372285,9252,10955621
406,2022-01-24,4117,4617505,2768.0,4043385,11211.0,1981263.0,88.0,331756.0,4205,4949261,2856,4375141,18184,10973805
407,2022-01-25,3791,4621296,3302.0,4046687,9141.0,1990404.0,93.0,331849.0,3884,4953145,3395,4378536,16327,10990132
408,2022-01-26,3841,4625137,3668.0,4050355,8946.0,1999350.0,93.0,331942.0,3934,4957079,3761,4382297,16548,11006680
409,2022-01-27,3753,4628890,3855.0,4054210,10172.0,2009522.0,186.0,332128.0,3939,4961018,4041,4386338,17966,11024646
410,2022-01-28,3816,4632706,3211.0,4057421,11074.0,2020596.0,75.0,332203.0,3891,4964909,3286,4389624,18176,11042822
411,2022-01-29,2264,4634970,2263.0,4059684,5841.0,2026437.0,117.0,332320.0,2381,4967290,2380,4392004,10485,11053307
412,2022-01-30,1507,4636477,1600.0,4061284,3737.0,2030174.0,16.0,332336.0,1523,4968813,1616,4393620,6860,11060167
413,2022-01-31,2966,4639443,3133.0,4064417,7553.0,2037727.0,58.0,332394.0,3024,4971837,3191,4396811,13710,11073877
414,2022-02-01,2615,4642058,3348.0,4067765,6657.0,2044384.0,75.0,332469.0,2690,4974527,3423,4400234,12695,11086572
415,2022-02-02,2766,4644824,3614.0,4071379,6414.0,2050798.0,71.0,332540.0,2837,4977364,3685,4403919,12865,11099437
416,2022-02-03,2681,4647505,3551.0,4074930,6511.0,2057309.0,42.0,332582.0,2723,4980087,3593,4407512,12785,11112222
417,2022-02-04,2580,4650085,4046.0,4078976,7170.0,2064479.0,115.0,332697.0,2695,4982782,4161,4411673,13911,11126133
418,2022-02-05,1803,4651888,2468.0,4081444,4815.0,2069294.0,110.0,332807.0,1913,4984695,2578,4414251,9196,11135329
419,2022-02-06,298,4652186,381.0,4081825,735.0,2070029.0,5.0,332812.0,303,4984998,386,4414637,1419,11136748
