,VACCINATION_DATE,FirstDailyDose,FirstDoseCumulative,SecondDailyDose,SecondDoseCumulative,AdditionalDailyDose,AdditionalDoseCumulative,SingleDailyDose,SingleDoseCumulative,AtleastOneVaccine,AtleastOneVaccineCumulative,CompletedVax,CompletedVaxCumulative,FirstSecondSingleVaccinations,FirstSecondSingleVaccinationsCumulative
0,2020-12-14 15:00:00,19,1582,,550,,2,,,19,1582,0,550,19,2069
1,2020-12-15 15:00:00,65,1647,3.0,553,,2,,,65,1647,3,553,68,2137
2,2020-12-16 15:00:00,600,2247,6.0,559,,2,,,600,2247,6,559,606,2743
3,2020-12-17 15:00:00,1173,3420,8.0,567,,2,,,1173,3420,8,567,1181,3924
4,2020-12-18 15:00:00,3036,6456,12.0,579,,2,,,3036,6456,12,579,3048,6972
5,2020-12-19 15:00:00,930,7386,8.0,587,,2,,,930,7386,8,587,938,7910
6,2020-12-20 15:00:00,371,7757,6.0,593,,2,,,371,7757,6,593,377,8287
7,2020-12-21 15:00:00,3906,11663,29.0,622,,2,,,3906,11663,29,622,3935,12222
8,2020-12-22 15:00:00,6335,17998,32.0,654,,2,,,6335,17998,32,654,6367,18589
9,2020-12-23 15:00:00,5805,23803,43.0,697,,2,,,5805,23803,43,697,5848,24437
10,2020-12-24 15:00:00,2732,26535,16.0,713,,2,,,2732,26535,16,713,2748,27185
11,2020-12-25 15:00:00,1035,27570,4.0,717,,2,,,1035,27570,4,717,1039,28224
12,2020-12-26 15:00:00,1888,29458,10.0,727,,2,,,1888,29458,10,727,1898,30122
13,2020-12-27 15:00:00,1811,31269,12.0,739,,2,,,1811,31269,12,739,1823,31945
14,2020-12-28 15:00:00,9021,40290,54.0,793,,2,,,9021,40290,54,793,9075,41020
15,2020-12-29 15:00:00,11008,51298,56.0,849,,2,,,11008,51298,56,849,11064,52084
16,2020-12-30 15:00:00,12541,63839,99.0,948,1.0,3,,,12541,63839,99,948,12641,64725
17,2020-12-31 15:00:00,7576,71415,50.0,998,,3,,,7576,71415,50,998,7626,72351
18,2021-01-01 15:00:00,3539,74954,152.0,1150,8.0,11,,,3539,74954,152,1150,3699,76050
19,2021-01-02 15:00:00,3091,78045,35.0,1185,,11,,,3091,78045,35,1185,3126,79176
20,2021-01-03 15:00:00,3433,81478,83.0,1268,,11,,,3433,81478,83,1268,3516,82692
21,2021-01-04 15:00:00,13410,94888,352.0,1620,2.0,13,,,13410,94888,352,1620,13764,96456
22,2021-01-05 15:00:00,12518,107406,563.0,2183,1.0,14,,,12518,107406,563,2183,13082,109538
23,2021-01-06 15:00:00,15314,122720,882.0,3065,1.0,15,,,15314,122720,882,3065,16197,125735
24,2021-01-07 15:00:00,15087,137807,1800.0,4865,,15,,,15087,137807,1800,4865,16887,142622
25,2021-01-08 15:00:00,24061,161868,2808.0,7673,,15,,,24061,161868,2808,7673,26869,169491
26,2021-01-09 15:00:00,5224,167092,963.0,8636,,15,,,5224,167092,963,8636,6187,175678
27,2021-01-10 15:00:00,3024,170116,391.0,9027,,15,,,3024,170116,391,9027,3415,179093
28,2021-01-11 15:00:00,13775,183891,3495.0,12522,2.0,17,,,13775,183891,3495,12522,17272,196365
29,2021-01-12 15:00:00,17429,201320,5606.0,18128,,17,,,17429,201320,5606,18128,23035,219400
30,2021-01-13 15:00:00,18674,219994,3952.0,22080,,17,,,18674,219994,3952,22080,22626,242026
31,2021-01-14 15:00:00,17908,237902,1980.0,24060,1.0,18,,,17908,237902,1980,24060,19889,261915
32,2021-01-15 15:00:00,19534,257436,2051.0,26111,3.0,21,,,19534,257436,2051,26111,21588,283503
33,2021-01-16 15:00:00,5859,263295,1635.0,27746,,21,,,5859,263295,1635,27746,7494,290997
34,2021-01-17 15:00:00,2132,265427,1483.0,29229,1.0,22,,,2132,265427,1483,29229,3616,294613
35,2021-01-18 15:00:00,7107,272534,3283.0,32512,3.0,25,,,7107,272534,3283,32512,10393,305006
36,2021-01-19 15:00:00,16988,289522,5444.0,37956,,25,,,16988,289522,5444,37956,22432,327438
37,2021-01-20 15:00:00,21033,310555,5363.0,43319,2.0,27,,,21033,310555,5363,43319,26398,353836
38,2021-01-21 15:00:00,23870,334425,3897.0,47216,2.0,29,,,23870,334425,3897,47216,27769,381605
39,2021-01-22 15:00:00,28681,363106,3793.0,51009,,29,,,28681,363106,3793,51009,32474,414079
40,2021-01-23 15:00:00,10152,373258,1959.0,52968,1.0,30,,,10152,373258,1959,52968,12112,426191
41,2021-01-24 15:00:00,3377,376635,1731.0,54699,1.0,31,,,3377,376635,1731,54699,5109,431300
42,2021-01-25 15:00:00,16349,392984,8652.0,63351,2.0,33,,,16349,392984,8652,63351,25003,456303
43,2021-01-26 15:00:00,17593,410577,9012.0,72363,2.0,35,,,17593,410577,9012,72363,26607,482910
44,2021-01-27 15:00:00,24467,435044,12621.0,84984,2.0,37,,,24467,435044,12621,84984,37090,520000
45,2021-01-28 15:00:00,22689,457733,9366.0,94350,3.0,40,,,22689,457733,9366,94350,32058,552058
46,2021-01-29 15:00:00,24841,482574,7978.0,102328,9.0,49,,,24841,482574,7978,102328,32828,584886
47,2021-01-30 15:00:00,17819,500393,2603.0,104931,4.0,53,,,17819,500393,2603,104931,20426,605312
48,2021-01-31 15:00:00,3774,504167,1388.0,106319,4.0,57,,,3774,504167,1388,106319,5166,610478
49,2021-02-01 15:00:00,8297,512464,5515.0,111834,59.0,116,,,8297,512464,5515,111834,13871,624349
50,2021-02-02 15:00:00,12558,525022,13871.0,125705,6.0,122,,,12558,525022,13871,125705,26435,650784
51,2021-02-03 15:00:00,18315,543337,18196.0,143901,2.0,124,,,18315,543337,18196,143901,36513,687297
52,2021-02-04 15:00:00,22181,565518,15868.0,159769,3.0,127,,,22181,565518,15868,159769,38052,725349
53,2021-02-05 15:00:00,20460,585978,17495.0,177264,6.0,133,,,20460,585978,17495,177264,37961,763310
54,2021-02-06 15:00:00,11432,597410,14575.0,191839,7.0,140,,,11432,597410,14575,191839,26014,789324
55,2021-02-07 15:00:00,6033,603443,1987.0,193826,2.0,142,,,6033,603443,1987,193826,8022,797346
56,2021-02-08 15:00:00,13046,616489,13013.0,206839,12.0,154,,,13046,616489,13013,206839,26071,823417
57,2021-02-09 15:00:00,16705,633194,13925.0,220764,,154,,,16705,633194,13925,220764,30630,854047
58,2021-02-10 15:00:00,19381,652575,21370.0,242134,5.0,159,,,19381,652575,21370,242134,40756,894803
59,2021-02-11 15:00:00,22970,675545,17434.0,259568,8.0,167,,,22970,675545,17434,259568,40412,935215
60,2021-02-12 15:00:00,20475,696020,19711.0,279279,10.0,177,,,20475,696020,19711,279279,40196,975411
61,2021-02-13 15:00:00,11496,707516,6443.0,285722,1.0,178,,,11496,707516,6443,285722,17940,993351
62,2021-02-14 15:00:00,7129,714645,2168.0,287890,3.0,181,,,7129,714645,2168,287890,9300,1002651
63,2021-02-15 15:00:00,11790,726435,13374.0,301264,16.0,197,,,11790,726435,13374,301264,25180,1027831
64,2021-02-16 15:00:00,16686,743121,21088.0,322352,9.0,206,,,16686,743121,21088,322352,37783,1065614
65,2021-02-17 15:00:00,20718,763839,26415.0,348767,8.0,214,,,20718,763839,26415,348767,47141,1112755
66,2021-02-18 15:00:00,3224,767063,4633.0,353400,5.0,219,,,3224,767063,4633,353400,7862,1120617
67,2021-02-19 15:00:00,10335,777398,19970.0,373370,8.0,227,,,10335,777398,19970,373370,30313,1150930
68,2021-02-20 15:00:00,10338,787736,20339.0,393709,4.0,231,,,10338,787736,20339,393709,30681,1181611
69,2021-02-21 15:00:00,6205,793941,7682.0,401391,8.0,239,,,6205,793941,7682,401391,13895,1195506
70,2021-02-22 15:00:00,8070,802011,15518.0,416909,14.0,253,,,8070,802011,15518,416909,23602,1219108
71,2021-02-23 15:00:00,15559,817570,16019.0,432928,6.0,259,,,15559,817570,16019,432928,31584,1250692
72,2021-02-24 15:00:00,18043,835613,24924.0,457852,8.0,267,,,18043,835613,24924,457852,42975,1293667
73,2021-02-25 15:00:00,20436,856049,26618.0,484470,8.0,275,,,20436,856049,26618,484470,47062,1340729
74,2021-02-26 15:00:00,26723,882772,26313.0,510783,14.0,289,,,26723,882772,26313,510783,53050,1393779
75,2021-02-27 15:00:00,16039,898811,11206.0,521989,8.0,297,,,16039,898811,11206,521989,27253,1421032
76,2021-02-28 15:00:00,15523,914334,4928.0,526917,22.0,319,,,15523,914334,4928,526917,20473,1441505
77,2021-03-01 15:00:00,27552,941886,12776.0,539693,61.0,380,,,27552,941886,12776,539693,40389,1481894
78,2021-03-02 15:00:00,24102,965988,13338.0,553031,9.0,389,38.0,38.0,24140,966026,13376,553069,37487,1519381
79,2021-03-03 15:00:00,30330,996318,18467.0,571498,11.0,400,198.0,236.0,30528,996554,18665,571734,49006,1568387
80,2021-03-04 15:00:00,31064,1027382,18301.0,589799,5.0,405,4067.0,4303.0,35131,1031685,22368,594102,53437,1621824
81,2021-03-05 15:00:00,30188,1057570,19815.0,609614,7.0,412,4921.0,9224.0,35109,1066794,24736,618838,54931,1676755
82,2021-03-06 15:00:00,19043,1076613,9560.0,619174,2.0,414,6012.0,15236.0,25055,1091849,15572,634410,34617,1711372
83,2021-03-07 15:00:00,12179,1088792,4935.0,624109,1.0,415,6609.0,21845.0,18788,1110637,11544,645954,23724,1735096
84,2021-03-08 15:00:00,25968,1114760,8890.0,632999,12.0,427,8275.0,30120.0,34243,1144880,17165,663119,43145,1778241
85,2021-03-09 15:00:00,26199,1140959,15542.0,648541,2.0,429,8349.0,38469.0,34548,1179428,23891,687010,50092,1828333
86,2021-03-10 15:00:00,29945,1170904,16127.0,664668,12.0,441,7937.0,46406.0,37882,1217310,24064,711074,54021,1882354
87,2021-03-11 15:00:00,36070,1206974,16463.0,681131,6.0,447,3982.0,50388.0,40052,1257362,20445,731519,56521,1938875
88,2021-03-12 15:00:00,36959,1243933,18262.0,699393,8.0,455,2935.0,53323.0,39894,1297256,21197,752716,58164,1997039
89,2021-03-13 15:00:00,22713,1266646,10371.0,709764,1.0,456,1636.0,54959.0,24349,1321605,12007,764723,34721,2031760
90,2021-03-14 15:00:00,17858,1284504,6746.0,716510,4.0,460,1016.0,55975.0,18874,1340479,7762,772485,25624,2057384
91,2021-03-15 15:00:00,29995,1314499,11404.0,727914,13.0,473,601.0,56576.0,30596,1371075,12005,784490,42013,2099397
92,2021-03-16 15:00:00,33543,1348042,13631.0,741545,14.0,487,775.0,57351.0,34318,1405393,14406,798896,47963,2147360
93,2021-03-17 15:00:00,37693,1385735,17153.0,758698,10.0,497,1185.0,58536.0,38878,1444271,18338,817234,56041,2203401
94,2021-03-18 15:00:00,41586,1427321,12748.0,771446,8.0,505,1355.0,59891.0,42941,1487212,14103,831337,55697,2259098
95,2021-03-19 15:00:00,38472,1465793,15477.0,786923,10.0,515,1057.0,60948.0,39529,1526741,16534,847871,55016,2314114
96,2021-03-20 15:00:00,24793,1490586,10278.0,797201,7.0,522,707.0,61655.0,25500,1552241,10985,858856,35785,2349899
97,2021-03-21 15:00:00,19236,1509822,7934.0,805135,10.0,532,345.0,62000.0,19581,1571822,8279,867135,27525,2377424
98,2021-03-22 15:00:00,32683,1542505,11562.0,816697,22.0,554,836.0,62836.0,33519,1605341,12398,879533,45103,2422527
99,2021-03-23 15:00:00,38454,1580959,17929.0,834626,5.0,559,1560.0,64396.0,40014,1645355,19489,899022,57948,2480475
100,2021-03-24 15:00:00,41130,1622089,21338.0,855964,13.0,572,1388.0,65784.0,42518,1687873,22726,921748,63869,2544344
101,2021-03-25 15:00:00,42981,1665070,21822.0,877786,6.0,578,2462.0,68246.0,45443,1733316,24284,946032,67271,2611615
102,2021-03-26 15:00:00,36448,1701518,26772.0,904558,7.0,585,2499.0,70745.0,38947,1772263,29271,975303,65726,2677341
103,2021-03-27 15:00:00,26508,1728026,17373.0,921931,8.0,593,2507.0,73252.0,29015,1801278,19880,995183,46396,2723737
104,2021-03-28 15:00:00,17034,1745060,12698.0,934629,9.0,602,1615.0,74867.0,18649,1819927,14313,1009496,31356,2755093
105,2021-03-29 15:00:00,29741,1774801,26477.0,961106,16.0,618,1146.0,76013.0,30887,1850814,27623,1037119,57380,2812473
106,2021-03-30 15:00:00,40156,1814957,29175.0,990281,6.0,624,1875.0,77888.0,42031,1892845,31050,1068169,71212,2883685
107,2021-03-31 15:00:00,41071,1856028,34864.0,1025145,18.0,642,5756.0,83644.0,46827,1939672,40620,1108789,81709,2965394
108,2021-04-01 15:00:00,42751,1898779,41358.0,1066503,81.0,723,5795.0,89439.0,48546,1988218,47153,1155942,89985,3055379
109,2021-04-02 15:00:00,35073,1933852,32828.0,1099331,14.0,737,6154.0,95593.0,41227,2029445,38982,1194924,74069,3129448
110,2021-04-03 15:00:00,21240,1955092,19282.0,1118613,4.0,741,4406.0,99999.0,25646,2055091,23688,1218612,44932,3174380
111,2021-04-04 15:00:00,8329,1963421,10235.0,1128848,3.0,744,970.0,100969.0,9299,2064390,11205,1229817,19537,3193917
112,2021-04-05 15:00:00,28030,1991451,29038.0,1157886,20.0,764,6674.0,107643.0,34704,2099094,35712,1265529,63762,3257679
113,2021-04-06 15:00:00,39886,2031337,30573.0,1188459,13.0,777,10524.0,118167.0,50410,2149504,41097,1306626,80996,3338675
114,2021-04-07 15:00:00,36209,2067546,34435.0,1222894,9.0,786,13011.0,131178.0,49220,2198724,47446,1354072,83664,3422339
115,2021-04-08 15:00:00,42388,2109934,36263.0,1259157,10.0,796,13908.0,145086.0,56296,2255020,50171,1404243,92569,3514908
116,2021-04-09 15:00:00,34204,2144138,36463.0,1295620,9.0,805,14566.0,159652.0,48770,2303790,51029,1455272,85242,3600150
117,2021-04-10 15:00:00,23699,2167837,23246.0,1318866,4.0,809,7664.0,167316.0,31363,2335153,30910,1486182,54613,3654763
118,2021-04-11 15:00:00,17610,2185447,13344.0,1332210,2.0,811,10138.0,177454.0,27748,2362901,23482,1509664,41094,3695857
119,2021-04-12 15:00:00,24646,2210093,33378.0,1365588,13.0,824,10936.0,188390.0,35582,2398483,44314,1553978,68973,3764830
120,2021-04-13 15:00:00,126255,2336348,91448.0,1457036,10.0,834,3298.0,191688.0,129553,2528036,94746,1648724,221011,3985841
121,2021-04-14 15:00:00,40908,2377256,37981.0,1495017,14.0,848,208.0,191896.0,41116,2569152,38189,1686913,79111,4064952
122,2021-04-15 15:00:00,41510,2418766,39723.0,1534740,22.0,870,169.0,192065.0,41679,2610831,39892,1726805,81424,4146376
123,2021-04-16 15:00:00,37304,2456070,39030.0,1573770,10.0,880,26.0,192091.0,37330,2648161,39056,1765861,76370,4222746
124,2021-04-17 15:00:00,32915,2488985,22121.0,1595891,12.0,892,13.0,192104.0,32928,2681089,22134,1787995,55061,4277807
125,2021-04-18 15:00:00,20108,2509093,16244.0,1612135,4.0,896,5.0,192109.0,20113,2701202,16249,1804244,36361,4314168
126,2021-04-19 15:00:00,29949,2539042,36652.0,1648787,17.0,913,62.0,192171.0,30011,2731213,36714,1840958,66680,4380848
127,2021-04-20 15:00:00,33014,2572056,44642.0,1693429,12.0,925,60.0,192231.0,33074,2764287,44702,1885660,77728,4458576
128,2021-04-21 15:00:00,39965,2612021,47199.0,1740628,14.0,939,26.0,192257.0,39991,2804278,47225,1932885,87204,4545780
129,2021-04-22 15:00:00,35966,2647987,42841.0,1783469,21.0,960,17.0,192274.0,35983,2840261,42858,1975743,78845,4624625
130,2021-04-23 15:00:00,33275,2681262,40307.0,1823776,9.0,969,14.0,192288.0,33289,2873550,40321,2016064,73605,4698230
131,2021-04-24 15:00:00,26506,2707768,28045.0,1851821,6.0,975,80.0,192368.0,26586,2900136,28125,2044189,54637,4752867
132,2021-04-25 15:00:00,20256,2728024,11038.0,1862859,8.0,983,31.0,192399.0,20287,2920423,11069,2055258,31333,4784200
133,2021-04-26 15:00:00,27438,2755462,32849.0,1895708,14.0,997,198.0,192597.0,27636,2948059,33047,2088305,60499,4844699
134,2021-04-27 15:00:00,26743,2782205,33229.0,1928937,9.0,1006,1099.0,193696.0,27842,2975901,34328,2122633,61080,4905779
135,2021-04-28 15:00:00,29080,2811285,39715.0,1968652,13.0,1019,1374.0,195070.0,30454,3006355,41089,2163722,70182,4975961
136,2021-04-29 15:00:00,27151,2838436,39853.0,2008505,12.0,1031,1469.0,196539.0,28620,3034975,41322,2205044,68485,5044446
137,2021-04-30 15:00:00,28272,2866708,32439.0,2040944,40.0,1071,1652.0,198191.0,29924,3064899,34091,2239135,62403,5106849
138,2021-05-01 15:00:00,20918,2887626,27132.0,2068076,67.0,1138,1068.0,199259.0,21986,3086885,28200,2267335,49185,5156034
139,2021-05-02 15:00:00,10299,2897925,17110.0,2085186,6.0,1144,826.0,200085.0,11125,3098010,17936,2285271,28241,5184275
140,2021-05-03 15:00:00,12812,2910737,28872.0,2114058,32.0,1176,1921.0,202006.0,14733,3112743,30793,2316064,43637,5227912
141,2021-05-04 15:00:00,13688,2924425,38904.0,2152962,9.0,1185,1748.0,203754.0,15436,3128179,40652,2356716,54349,5282261
142,2021-05-05 15:00:00,19374,2943799,37936.0,2190898,22.0,1207,1947.0,205701.0,21321,3149500,39883,2396599,59279,5341540
143,2021-05-06 15:00:00,16961,2960760,40678.0,2231576,11.0,1218,1729.0,207430.0,18690,3168190,42407,2439006,59379,5400919
144,2021-05-07 15:00:00,17608,2978368,37186.0,2268762,17.0,1235,1965.0,209395.0,19573,3187763,39151,2478157,56776,5457695
145,2021-05-08 15:00:00,10803,2989171,31311.0,2300073,2.0,1237,1299.0,210694.0,12102,3199865,32610,2510767,43415,5501110
146,2021-05-09 15:00:00,5083,2994254,12277.0,2312350,9.0,1246,697.0,211391.0,5780,3205645,12974,2523741,18066,5519176
147,2021-05-10 15:00:00,8976,3003230,31139.0,2343489,14.0,1260,1374.0,212765.0,10350,3215995,32513,2556254,41503,5560679
148,2021-05-11 15:00:00,12211,3015441,30375.0,2373864,9.0,1269,1445.0,214210.0,13656,3229651,31820,2588074,44040,5604719
149,2021-05-12 15:00:00,13983,3029424,38781.0,2412645,15.0,1284,1931.0,216141.0,15914,3245565,40712,2628786,54710,5659429
150,2021-05-13 15:00:00,21868,3051292,33610.0,2446255,7.0,1291,1350.0,217491.0,23218,3268783,34960,2663746,56835,5716264
151,2021-05-14 15:00:00,24465,3075757,30202.0,2476457,11.0,1302,1778.0,219269.0,26243,3295026,31980,2695726,56456,5772720
152,2021-05-15 15:00:00,22023,3097780,25211.0,2501668,6.0,1308,1501.0,220770.0,23524,3318550,26712,2722438,48741,5821461
153,2021-05-16 15:00:00,9121,3106901,17624.0,2519292,3.0,1311,1117.0,221887.0,10238,3328788,18741,2741179,27865,5849326
154,2021-05-17 15:00:00,16914,3123815,28497.0,2547789,12.0,1323,1956.0,223843.0,18870,3347658,30453,2771632,47379,5896705
155,2021-05-18 15:00:00,21326,3145141,30814.0,2578603,4.0,1327,1956.0,225799.0,23282,3370940,32770,2804402,54100,5950805
156,2021-05-19 15:00:00,27795,3172936,32603.0,2611206,9.0,1336,1645.0,227444.0,29440,3400380,34248,2838650,62052,6012857
157,2021-05-20 15:00:00,20900,3193836,33411.0,2644617,10.0,1346,1973.0,229417.0,22873,3423253,35384,2874034,56294,6069151
158,2021-05-21 15:00:00,19229,3213065,30515.0,2675132,7.0,1353,1611.0,231028.0,20840,3444093,32126,2906160,51362,6120513
159,2021-05-22 15:00:00,17041,3230106,20806.0,2695938,6.0,1359,1272.0,232300.0,18313,3462406,22078,2928238,39125,6159638
160,2021-05-23 15:00:00,8818,3238924,11488.0,2707426,3.0,1362,963.0,233263.0,9781,3472187,12451,2940689,21272,6180910
161,2021-05-24 15:00:00,13600,3252524,17874.0,2725300,7.0,1369,1482.0,234745.0,15082,3487269,19356,2960045,32963,6213873
162,2021-05-25 15:00:00,13131,3265655,18829.0,2744129,6.0,1375,1332.0,236077.0,14463,3501732,20161,2980206,33298,6247171
163,2021-05-26 15:00:00,18503,3284158,19811.0,2763940,3.0,1378,1518.0,237595.0,20021,3521753,21329,3001535,39835,6287006
164,2021-05-27 15:00:00,11755,3295913,18840.0,2782780,4.0,1382,1131.0,238726.0,12886,3534639,19971,3021506,31730,6318736
165,2021-05-28 15:00:00,12467,3308380,19932.0,2802712,15.0,1397,1408.0,240134.0,13875,3548514,21340,3042846,33822,6352558
166,2021-05-29 15:00:00,9554,3317934,11798.0,2814510,7.0,1404,941.0,241075.0,10495,3559009,12739,3055585,22300,6374858
167,2021-05-30 15:00:00,4982,3322916,6476.0,2820986,1.0,1405,598.0,241673.0,5580,3564589,7074,3062659,12057,6386915
168,2021-05-31 15:00:00,1783,3324699,3729.0,2824715,19.0,1424,303.0,241976.0,2086,3566675,4032,3066691,5834,6392749
169,2021-06-01 15:00:00,9908,3334607,16609.0,2841324,34.0,1458,1166.0,243142.0,11074,3577749,17775,3084466,27717,6420466
170,2021-06-02 15:00:00,10345,3344952,16928.0,2858252,9.0,1467,972.0,244114.0,11317,3589066,17900,3102366,28254,6448720
171,2021-06-03 15:00:00,7933,3352885,21307.0,2879559,2.0,1469,1093.0,245207.0,9026,3598092,22400,3124766,30335,6479055
172,2021-06-04 15:00:00,8256,3361141,22485.0,2902044,7.0,1476,1123.0,246330.0,9379,3607471,23608,3148374,31871,6510926
173,2021-06-05 15:00:00,7043,3368184,19555.0,2921599,1.0,1477,722.0,247052.0,7765,3615236,20277,3168651,27321,6538247
174,2021-06-06 15:00:00,3466,3371650,7310.0,2928909,,1477,427.0,247479.0,3893,3619129,7737,3176388,11203,6549450
175,2021-06-07 15:00:00,6882,3378532,15890.0,2944799,9.0,1486,729.0,248208.0,7611,3626740,16619,3193007,23510,6572960
176,2021-06-08 15:00:00,6704,3385236,19838.0,2964637,5.0,1491,835.0,249043.0,7539,3634279,20673,3213680,27382,6600342
177,2021-06-09 15:00:00,8281,3393517,24174.0,2988811,1.0,1492,975.0,250018.0,9256,3643535,25149,3238829,33431,6633773
178,2021-06-10 15:00:00,7200,3400717,19230.0,3008041,1.0,1493,899.0,250917.0,8099,3651634,20129,3258958,27330,6661103
179,2021-06-11 15:00:00,7527,3408244,17847.0,3025888,4.0,1497,1126.0,252043.0,8653,3660287,18973,3277931,26504,6687607
180,2021-06-12 15:00:00,5268,3413512,14897.0,3040785,2.0,1499,606.0,252649.0,5874,3666161,15503,3293434,20773,6708380
181,2021-06-13 15:00:00,1953,3415465,7666.0,3048451,,1499,427.0,253076.0,2380,3668541,8093,3301527,10046,6718426
182,2021-06-14 15:00:00,5661,3421126,11908.0,3060359,7.0,1506,736.0,253812.0,6397,3674938,12644,3314171,18312,6736738
183,2021-06-15 15:00:00,5687,3426813,14429.0,3074788,3.0,1509,876.0,254688.0,6563,3681501,15305,3329476,20995,6757733
184,2021-06-16 15:00:00,8799,3435612,21795.0,3096583,3.0,1512,762.0,255450.0,9561,3691062,22557,3352033,31359,6789092
185,2021-06-17 15:00:00,6697,3442309,12477.0,3109060,2.0,1514,724.0,256174.0,7421,3698483,13201,3365234,19900,6808992
186,2021-06-18 15:00:00,6874,3449183,12892.0,3121952,4.0,1518,707.0,256881.0,7581,3706064,13599,3378833,20477,6829469
187,2021-06-19 15:00:00,4678,3453861,9466.0,3131418,2.0,1520,615.0,257496.0,5293,3711357,10081,3388914,14761,6844230
188,2021-06-20 15:00:00,2526,3456387,5085.0,3136503,1.0,1521,376.0,257872.0,2902,3714259,5461,3394375,7988,6852218
189,2021-06-21 15:00:00,5603,3461990,5388.0,3141891,5.0,1526,640.0,258512.0,6243,3720502,6028,3400403,11636,6863854
190,2021-06-22 15:00:00,5438,3467428,9145.0,3151036,1.0,1527,701.0,259213.0,6139,3726641,9846,3410249,15285,6879139
191,2021-06-23 15:00:00,6112,3473540,10460.0,3161496,5.0,1532,647.0,259860.0,6759,3733400,11107,3421356,17224,6896363
192,2021-06-24 15:00:00,5957,3479497,8283.0,3169779,3.0,1535,596.0,260456.0,6553,3739953,8879,3430235,14839,6911202
193,2021-06-25 15:00:00,5874,3485371,8755.0,3178534,4.0,1539,615.0,261071.0,6489,3746442,9370,3439605,15248,6926450
194,2021-06-26 15:00:00,3725,3489096,6345.0,3184879,,1539,399.0,261470.0,4124,3750566,6744,3446349,10469,6936919
195,2021-06-27 15:00:00,2814,3491910,3540.0,3188419,,1539,185.0,261655.0,2999,3753565,3725,3450074,6539,6943458
196,2021-06-28 15:00:00,4976,3496886,6455.0,3194874,7.0,1546,540.0,262195.0,5516,3759081,6995,3457069,11978,6955436
197,2021-06-29 15:00:00,5094,3501980,6551.0,3201425,5.0,1551,524.0,262719.0,5618,3764699,7075,3464144,12174,6967610
198,2021-06-30 15:00:00,5690,3507670,7512.0,3208937,4.0,1555,608.0,263327.0,6298,3770997,8120,3472264,13814,6981424
199,2021-07-01 15:00:00,5442,3513112,7043.0,3215980,11.0,1566,508.0,263835.0,5950,3776947,7551,3479815,13004,6994428
200,2021-07-02 15:00:00,5304,3518416,6875.0,3222855,2.0,1568,526.0,264361.0,5830,3782777,7401,3487216,12707,7007135
201,2021-07-03 15:00:00,3273,3521689,4078.0,3226933,1.0,1569,263.0,264624.0,3536,3786313,4341,3491557,7615,7014750
202,2021-07-04 15:00:00,494,3522183,548.0,3227481,,1569,70.0,264694.0,564,3786877,618,3492175,1112,7015862
203,2021-07-05 15:00:00,3770,3525953,3947.0,3231428,3.0,1572,287.0,264981.0,4057,3790934,4234,3496409,8007,7023869
204,2021-07-06 15:00:00,4478,3530431,6305.0,3237733,3.0,1575,454.0,265435.0,4932,3795866,6759,3503168,11240,7035109
205,2021-07-07 15:00:00,4462,3534893,6442.0,3244175,,1575,484.0,265919.0,4946,3800812,6926,3510094,11388,7046497
206,2021-07-08 15:00:00,4830,3539723,6196.0,3250371,3.0,1578,565.0,266484.0,5395,3806207,6761,3516855,11594,7058091
207,2021-07-09 15:00:00,5354,3545077,6717.0,3257088,1.0,1579,574.0,267058.0,5928,3812135,7291,3524146,12646,7070737
208,2021-07-10 15:00:00,3523,3548600,4436.0,3261524,,1579,305.0,267363.0,3828,3815963,4741,3528887,8264,7079001
209,2021-07-11 15:00:00,2683,3551283,2583.0,3264107,,1579,227.0,267590.0,2910,3818873,2810,3531697,5493,7084494
210,2021-07-12 15:00:00,4428,3555711,5133.0,3269240,6.0,1585,379.0,267969.0,4807,3823680,5512,3537209,9946,7094440
211,2021-07-13 15:00:00,4643,3560354,4770.0,3274010,2.0,1587,366.0,268335.0,5009,3828689,5136,3542345,9781,7104221
212,2021-07-14 15:00:00,4620,3564974,5322.0,3279332,4.0,1591,423.0,268758.0,5043,3833732,5745,3548090,10369,7114590
213,2021-07-15 15:00:00,4901,3569875,5048.0,3284380,1.0,1592,359.0,269117.0,5260,3838992,5407,3553497,10309,7124899
214,2021-07-16 15:00:00,6273,3576148,5891.0,3290271,1.0,1593,405.0,269522.0,6678,3845670,6296,3559793,12570,7137469
215,2021-07-17 15:00:00,3421,3579569,3554.0,3293825,1.0,1594,304.0,269826.0,3725,3849395,3858,3563651,7280,7144749
216,2021-07-18 15:00:00,2307,3581876,2390.0,3296215,,1594,110.0,269936.0,2417,3851812,2500,3566151,4807,7149556
217,2021-07-19 15:00:00,5148,3587024,4630.0,3300845,2.0,1596,383.0,270319.0,5531,3857343,5013,3571164,10163,7159719
218,2021-07-20 15:00:00,5337,3592361,4754.0,3305599,1.0,1597,366.0,270685.0,5703,3863046,5120,3576284,10458,7170177
219,2021-07-21 15:00:00,5665,3598026,4978.0,3310577,4.0,1601,415.0,271100.0,6080,3869126,5393,3581677,11062,7181239
220,2021-07-22 15:00:00,6031,3604057,4668.0,3315245,2.0,1603,471.0,271571.0,6502,3875628,5139,3586816,11172,7192411
221,2021-07-23 15:00:00,6858,3610915,4868.0,3320113,1.0,1604,500.0,272071.0,7358,3882986,5368,3592184,12227,7204638
222,2021-07-24 15:00:00,4284,3615199,3209.0,3323322,,1604,267.0,272338.0,4551,3887537,3476,3595660,7760,7212398
223,2021-07-25 15:00:00,3306,3618505,1123.0,3324445,,1604,142.0,272480.0,3448,3890985,1265,3596925,4571,7216969
224,2021-07-26 15:00:00,6221,3624726,3930.0,3328375,2.0,1606,420.0,272900.0,6641,3897626,4350,3601275,10573,7227542
225,2021-07-27 15:00:00,6617,3631343,4311.0,3332686,,1606,460.0,273360.0,7077,3904703,4771,3606046,11388,7238930
226,2021-07-28 15:00:00,7089,3638432,4175.0,3336861,2.0,1608,461.0,273821.0,7550,3912253,4636,3610682,11727,7250657
227,2021-07-29 15:00:00,7092,3645524,4329.0,3341190,3.0,1611,421.0,274242.0,7513,3919766,4750,3615432,11845,7262502
228,2021-07-30 15:00:00,7823,3653347,4854.0,3346044,1.0,1612,525.0,274767.0,8348,3928114,5379,3620811,13203,7275705
229,2021-07-31 15:00:00,4798,3658145,3089.0,3349133,2.0,1614,274.0,275041.0,5072,3933186,3363,3624174,8163,7283868
230,2021-08-01 15:00:00,3935,3662080,2215.0,3351348,198.0,1812,165.0,275206.0,4100,3937286,2380,3626554,6513,7290381
231,2021-08-02 15:00:00,7285,3669365,3865.0,3355213,144.0,1956,342.0,275548.0,7627,3944913,4207,3630761,11636,7302017
232,2021-08-03 15:00:00,7284,3676649,4113.0,3359326,102.0,2058,518.0,276066.0,7802,3952715,4631,3635392,12017,7314034
233,2021-08-04 15:00:00,7452,3684101,4129.0,3363455,106.0,2164,536.0,276602.0,7988,3960703,4665,3640057,12223,7326257
234,2021-08-05 15:00:00,7968,3692069,4355.0,3367810,105.0,2269,542.0,277144.0,8510,3969213,4897,3644954,12970,7339227
235,2021-08-06 15:00:00,8339,3700408,4760.0,3372570,138.0,2407,455.0,277599.0,8794,3978007,5215,3650169,13692,7352919
236,2021-08-07 15:00:00,5311,3705719,2855.0,3375425,95.0,2502,263.0,277862.0,5574,3983581,3118,3653287,8524,7361443
237,2021-08-08 15:00:00,3978,3709697,2063.0,3377488,74.0,2576,146.0,278008.0,4124,3987705,2209,3655496,6261,7367704
238,2021-08-09 15:00:00,6960,3716657,4579.0,3382067,111.0,2687,371.0,278379.0,7331,3995036,4950,3660446,12021,7379725
239,2021-08-10 15:00:00,7176,3723833,4522.0,3386589,117.0,2804,340.0,278719.0,7516,4002552,4862,3665308,12155,7391880
240,2021-08-11 15:00:00,7109,3730942,4471.0,3391060,115.0,2919,442.0,279161.0,7551,4010103,4913,3670221,12137,7404017
241,2021-08-12 15:00:00,8677,3739619,4780.0,3395840,158.0,3077,446.0,279607.0,9123,4019226,5226,3675447,14061,7418078
242,2021-08-13 15:00:00,7190,3746809,5432.0,3401272,205.0,3282,398.0,280005.0,7588,4026814,5830,3681277,13225,7431303
243,2021-08-14 15:00:00,4929,3751738,3362.0,3404634,686.0,3968,287.0,280292.0,5216,4032030,3649,3684926,9264,7440567
244,2021-08-15 15:00:00,3333,3755071,2755.0,3407389,577.0,4545,164.0,280456.0,3497,4035527,2919,3687845,6829,7447396
245,2021-08-16 15:00:00,5464,3760535,5116.0,3412505,1257.0,5802,353.0,280809.0,5817,4041344,5469,3693314,12190,7459586
246,2021-08-17 15:00:00,6834,3767369,5389.0,3417894,1455.0,7257,391.0,281200.0,7225,4048569,5780,3699094,14069,7473655
247,2021-08-18 15:00:00,6358,3773727,5551.0,3423445,1647.0,8904,482.0,281682.0,6840,4055409,6033,3705127,14038,7487693
248,2021-08-19 15:00:00,6248,3779975,5599.0,3429044,1641.0,10545,415.0,282097.0,6663,4062072,6014,3711141,13903,7501596
249,2021-08-20 15:00:00,6859,3786834,6581.0,3435625,1743.0,12288,401.0,282498.0,7260,4069332,6982,3718123,15584,7517180
250,2021-08-21 15:00:00,4351,3791185,3934.0,3439559,888.0,13176,230.0,282728.0,4581,4073913,4164,3722287,9403,7526583
251,2021-08-22 15:00:00,3063,3794248,3184.0,3442743,811.0,13987,111.0,282839.0,3174,4077087,3295,3725582,7169,7533752
252,2021-08-23 15:00:00,6006,3800254,6150.0,3448893,1816.0,15803,287.0,283126.0,6293,4083380,6437,3732019,14259,7548011
253,2021-08-24 15:00:00,6557,3806811,6110.0,3455003,1748.0,17551,426.0,283552.0,6983,4090363,6536,3738555,14841,7562852
254,2021-08-25 15:00:00,6741,3813552,6257.0,3461260,1616.0,19167,441.0,283993.0,7182,4097545,6698,3745253,15055,7577907
255,2021-08-26 15:00:00,6972,3820524,6690.0,3467950,1739.0,20906,427.0,284420.0,7399,4104944,7117,3752370,15828,7593735
256,2021-08-27 15:00:00,6848,3827372,7112.0,3475062,2028.0,22934,317.0,284737.0,7165,4112109,7429,3759799,16305,7610040
257,2021-08-28 15:00:00,6920,3834292,6547.0,3481609,1012.0,23946,329.0,285066.0,7249,4119358,6876,3766675,14808,7624848
258,2021-08-29 15:00:00,3746,3838038,3708.0,3485317,685.0,24631,610.0,285676.0,4356,4123714,4318,3770993,8749,7633597
259,2021-08-30 15:00:00,5944,3843982,6166.0,3491483,1548.0,26179,963.0,286639.0,6907,4130621,7129,3778122,14621,7648218
260,2021-08-31 15:00:00,5920,3849902,6106.0,3497589,1672.0,27851,949.0,287588.0,6869,4137490,7055,3785177,14647,7662865
261,2021-09-01 15:00:00,5647,3855549,5765.0,3503354,1844.0,29695,923.0,288511.0,6570,4144060,6688,3791865,14179,7677044
262,2021-09-02 15:00:00,5527,3861076,5991.0,3509345,1871.0,31566,710.0,289221.0,6237,4150297,6701,3798566,14099,7691143
263,2021-09-03 15:00:00,6034,3867110,6996.0,3516341,1862.0,33428,979.0,290200.0,7013,4157310,7975,3806541,15871,7707014
264,2021-09-04 15:00:00,3743,3870853,4366.0,3520707,884.0,34312,878.0,291078.0,4621,4161931,5244,3811785,9871,7716885
265,2021-09-05 15:00:00,2958,3873811,2820.0,3523527,667.0,34979,107.0,291185.0,3065,4164996,2927,3814712,6552,7723437
266,2021-09-06 15:00:00,1065,3874876,1164.0,3524691,225.0,35204,71.0,291256.0,1136,4166132,1235,3815947,2525,7725962
267,2021-09-07 15:00:00,5360,3880236,7330.0,3532021,1439.0,36643,2306.0,293562.0,7666,4173798,9636,3825583,16435,7742397
268,2021-09-08 15:00:00,4663,3884899,5519.0,3537540,1580.0,38223,365.0,293927.0,5028,4178826,5884,3831467,12127,7754524
269,2021-09-09 15:00:00,5029,3889928,5499.0,3543039,2322.0,40545,327.0,294254.0,5356,4184182,5826,3837293,13177,7767701
270,2021-09-10 15:00:00,6537,3896465,6696.0,3549735,2501.0,43046,1719.0,295973.0,8256,4192438,8415,3845708,17453,7785154
271,2021-09-11 15:00:00,4183,3900648,4361.0,3554096,1017.0,44063,668.0,296641.0,4851,4197289,5029,3850737,10229,7795383
272,2021-09-12 15:00:00,3180,3903828,3254.0,3557350,702.0,44765,436.0,297077.0,3616,4200905,3690,3854427,7572,7802955
273,2021-09-13 15:00:00,4903,3908731,5092.0,3562442,1544.0,46309,351.0,297428.0,5254,4206159,5443,3859870,11890,7814845
274,2021-09-14 15:00:00,4788,3913519,5477.0,3567919,1613.0,47922,439.0,297867.0,5227,4211386,5916,3865786,12317,7827162
275,2021-09-15 15:00:00,5056,3918575,5926.0,3573845,1508.0,49430,394.0,298261.0,5450,4216836,6320,3872106,12884,7840046
276,2021-09-16 15:00:00,4821,3923396,5868.0,3579713,1619.0,51049,342.0,298603.0,5163,4221999,6210,3878316,12650,7852696
277,2021-09-17 15:00:00,5288,3928684,6600.0,3586313,1946.0,52995,347.0,298950.0,5635,4227634,6947,3885263,14181,7866877
278,2021-09-18 15:00:00,3826,3932510,4604.0,3590917,937.0,53932,186.0,299136.0,4012,4231646,4790,3890053,9553,7876430
279,2021-09-19 15:00:00,2743,3935253,3186.0,3594103,701.0,54633,75.0,299211.0,2818,4234464,3261,3893314,6705,7883135
280,2021-09-20 15:00:00,3757,3939010,4698.0,3598801,1766.0,56399,428.0,299639.0,4185,4238649,5126,3898440,10649,7893784
281,2021-09-21 15:00:00,4004,3943014,5041.0,3603842,1880.0,58279,341.0,299980.0,4345,4242994,5382,3903822,11266,7905050
282,2021-09-22 15:00:00,4198,3947212,4809.0,3608651,1768.0,60047,459.0,300439.0,4657,4247651,5268,3909090,11234,7916284
283,2021-09-23 15:00:00,4191,3951403,4736.0,3613387,2210.0,62257,494.0,300933.0,4685,4252336,5230,3914320,11631,7927915
284,2021-09-24 15:00:00,5103,3956506,5652.0,3619039,4852.0,67109,422.0,301355.0,5525,4257861,6074,3920394,16029,7943944
285,2021-09-25 15:00:00,3638,3960144,3648.0,3622687,4941.0,72050,384.0,301739.0,4022,4261883,4032,3924426,12611,7956555
286,2021-09-26 15:00:00,2351,3962495,2677.0,3625364,3093.0,75143,435.0,302174.0,2786,4264669,3112,3927538,8556,7965111
287,2021-09-27 15:00:00,4505,3967000,2729.0,3628093,8907.0,84050,514.0,302688.0,5019,4269688,3243,3930781,16655,7981766
288,2021-09-28 15:00:00,4413,3971413,4496.0,3632589,9632.0,93682,212.0,302900.0,4625,4274313,4708,3935489,18753,8000519
289,2021-09-29 15:00:00,4687,3976100,4537.0,3637126,9897.0,103579,920.0,303820.0,5607,4279920,5457,3940946,20041,8020560
290,2021-09-30 15:00:00,4897,3980997,4598.0,3641724,10009.0,113588,796.0,304616.0,5693,4285613,5394,3946340,20300,8040860
291,2021-10-01 15:00:00,5541,3986538,5386.0,3647110,12160.0,125748,794.0,305410.0,6335,4291948,6180,3952520,23881,8064741
292,2021-10-02 15:00:00,2946,3989484,2909.0,3650019,5798.0,131546,187.0,305597.0,3133,4295081,3096,3955616,11840,8076581
293,2021-10-03 15:00:00,2081,3991565,2383.0,3652402,3479.0,135025,87.0,305684.0,2168,4297249,2470,3958086,8030,8084611
294,2021-10-04 15:00:00,4030,3995595,3519.0,3655921,9894.0,144919,253.0,305937.0,4283,4301532,3772,3961858,17696,8102307
295,2021-10-05 15:00:00,3960,3999555,3692.0,3659613,10291.0,155210,209.0,306146.0,4169,4305701,3901,3965759,18152,8120459
296,2021-10-06 15:00:00,4038,4003593,3591.0,3663204,9055.0,164265,266.0,306412.0,4304,4310005,3857,3969616,16950,8137409
297,2021-10-07 15:00:00,4234,4007827,3673.0,3666877,10066.0,174331,333.0,306745.0,4567,4314572,4006,3973622,18306,8155715
298,2021-10-08 15:00:00,4789,4012616,4318.0,3671195,11576.0,185907,283.0,307028.0,5072,4319644,4601,3978223,20966,8176681
299,2021-10-09 15:00:00,2686,4015302,2689.0,3673884,4323.0,190230,270.0,307298.0,2956,4322600,2959,3981182,9968,8186649
300,2021-10-10 15:00:00,1855,4017157,1860.0,3675744,3605.0,193835,60.0,307358.0,1915,4324515,1920,3983102,7380,8194029
301,2021-10-11 15:00:00,4208,4021365,3329.0,3679073,9304.0,203139,251.0,307609.0,4459,4328974,3580,3986682,17092,8211121
302,2021-10-12 15:00:00,3608,4024973,3554.0,3682627,9843.0,212982,277.0,307886.0,3885,4332859,3831,3990513,17282,8228403
303,2021-10-13 15:00:00,4002,4028975,3498.0,3686125,9101.0,222083,359.0,308245.0,4361,4337220,3857,3994370,16960,8245363
304,2021-10-14 15:00:00,5168,4034143,5522.0,3691647,9588.0,231671,434.0,308679.0,5602,4342822,5956,4000326,20712,8266075
305,2021-10-15 15:00:00,4768,4038911,4637.0,3696284,10716.0,242387,348.0,309027.0,5116,4347938,4985,4005311,20469,8286544
306,2021-10-16 15:00:00,2499,4041410,2534.0,3698818,4706.0,247093,291.0,309318.0,2790,4350728,2825,4008136,10030,8296574
307,2021-10-17 15:00:00,1810,4043220,1781.0,3700599,2804.0,249897,55.0,309373.0,1865,4352593,1836,4009972,6450,8303024
308,2021-10-18 15:00:00,4278,4047498,3579.0,3704178,9331.0,259228,282.0,309655.0,4560,4357153,3861,4013833,17470,8320494
309,2021-10-19 15:00:00,4303,4051801,4038.0,3708216,9678.0,268906,223.0,309878.0,4526,4361679,4261,4018094,18242,8338736
310,2021-10-20 15:00:00,3549,4055350,3433.0,3711649,9160.0,278066,260.0,310138.0,3809,4365488,3693,4021787,16402,8355138
311,2021-10-21 15:00:00,3309,4058659,3294.0,3714943,10087.0,288153,291.0,310429.0,3600,4369088,3585,4025372,16981,8372119
312,2021-10-22 15:00:00,4677,4063336,4042.0,3718985,18972.0,307125,477.0,310906.0,5154,4374242,4519,4029891,28168,8400287
313,2021-10-23 15:00:00,2884,4066220,2121.0,3721106,11154.0,318279,322.0,311228.0,3206,4377448,2443,4032334,16481,8416768
314,2021-10-24 15:00:00,2052,4068272,1555.0,3722661,7229.0,325508,79.0,311307.0,2131,4379579,1634,4033968,10915,8427683
315,2021-10-25 15:00:00,4549,4072821,3080.0,3725741,23374.0,348882,324.0,311631.0,4873,4384452,3404,4037372,31327,8459010
316,2021-10-26 15:00:00,4538,4077359,3088.0,3728829,25765.0,374647,315.0,311946.0,4853,4389305,3403,4040775,33706,8492716
317,2021-10-27 15:00:00,4717,4082076,3359.0,3732188,25776.0,400423,434.0,312380.0,5151,4394456,3793,4044568,34286,8527002
318,2021-10-28 15:00:00,4551,4086627,3381.0,3735569,26732.0,427155,501.0,312881.0,5052,4399508,3882,4048450,35165,8562167
319,2021-10-29 15:00:00,4985,4091612,3938.0,3739507,26630.0,453785,395.0,313276.0,5380,4404888,4333,4052783,35948,8598115
320,2021-10-30 15:00:00,2626,4094238,1848.0,3741355,13788.0,467573,307.0,313583.0,2933,4407821,2155,4054938,18569,8616684
321,2021-10-31 15:00:00,1931,4096169,1522.0,3742877,7874.0,475447,94.0,313677.0,2025,4409846,1616,4056554,11421,8628105
322,2021-11-01 15:00:00,4765,4100934,3468.0,3746345,26193.0,501640,352.0,314029.0,5117,4414963,3820,4060374,34778,8662883
323,2021-11-02 15:00:00,4259,4105193,2952.0,3749297,26277.0,527917,410.0,314439.0,4669,4419632,3362,4063736,33898,8696781
324,2021-11-03 15:00:00,4670,4109863,3062.0,3752359,26392.0,554309,461.0,314900.0,5131,4424763,3523,4067259,34585,8731366
325,2021-11-04 15:00:00,6311,4116174,3378.0,3755737,27456.0,581765,530.0,315430.0,6841,4431604,3908,4071167,37675,8769041
326,2021-11-05 15:00:00,8252,4124426,3786.0,3759523,28404.0,610169,414.0,315844.0,8666,4440270,4200,4075367,40856,8809897
327,2021-11-06 15:00:00,10197,4134623,1979.0,3761502,13089.0,623258,309.0,316153.0,10506,4450776,2288,4077655,25574,8835471
328,2021-11-07 15:00:00,7761,4142384,1466.0,3762968,7429.0,630687,95.0,316248.0,7856,4458632,1561,4079216,16751,8852222
329,2021-11-08 15:00:00,11364,4153748,3065.0,3766033,19842.0,650529,379.0,316627.0,11743,4470375,3444,4082660,34650,8886872
330,2021-11-09 15:00:00,11806,4165554,2653.0,3768686,23361.0,673890,267.0,316894.0,12073,4482448,2920,4085580,38087,8924959
331,2021-11-10 15:00:00,12642,4178196,2783.0,3771469,23980.0,697870,356.0,317250.0,12998,4495446,3139,4088719,39761,8964720
332,2021-11-11 15:00:00,11443,4189639,2382.0,3773851,22310.0,720180,279.0,317529.0,11722,4507168,2661,4091380,36414,9001134
333,2021-11-12 15:00:00,12401,4202040,3374.0,3777225,26466.0,746646,547.0,318076.0,12948,4520116,3921,4095301,42788,9043922
334,2021-11-13 15:00:00,9996,4212036,1603.0,3778828,12530.0,759176,343.0,318419.0,10339,4530455,1946,4097247,24472,9068394
335,2021-11-14 15:00:00,4256,4216292,1116.0,3779944,7364.0,766540,121.0,318540.0,4377,4534832,1237,4098484,12857,9081251
336,2021-11-15 15:00:00,8675,4224967,2524.0,3782468,21121.0,787661,210.0,318750.0,8885,4543717,2734,4101218,32530,9113781
337,2021-11-16 15:00:00,9312,4234279,2520.0,3784988,23409.0,811070,258.0,319008.0,9570,4553287,2778,4103996,35499,9149280
338,2021-11-17 15:00:00,9444,4243723,2867.0,3787855,23022.0,834092,313.0,319321.0,9757,4563044,3180,4107176,35646,9184926
339,2021-11-18 15:00:00,9336,4253059,2632.0,3790487,23066.0,857158,483.0,319804.0,9819,4572863,3115,4110291,35517,9220443
340,2021-11-19 15:00:00,9887,4262946,2939.0,3793426,28083.0,885241,397.0,320201.0,10284,4583147,3336,4113627,41306,9261749
341,2021-11-20 15:00:00,10658,4273604,1607.0,3795033,14655.0,899896,455.0,320656.0,11113,4594260,2062,4115689,27375,9289124
342,2021-11-21 15:00:00,4393,4277997,1214.0,3796247,10064.0,909960,100.0,320756.0,4493,4598753,1314,4117003,15771,9304895
343,2021-11-22 15:00:00,9854,4287851,2522.0,3798769,25164.0,935124,293.0,321049.0,10147,4608900,2815,4119818,37833,9342728
344,2021-11-23 15:00:00,9276,4297127,2403.0,3801172,25392.0,960516,321.0,321370.0,9597,4618497,2724,4122542,37392,9380120
345,2021-11-24 15:00:00,8215,4305342,2442.0,3803614,20542.0,981058,220.0,321590.0,8435,4626932,2662,4125204,31419,9411539
346,2021-11-25 15:00:00,240,4305582,82.0,3803696,620.0,981678,10.0,321600.0,250,4627182,92,4125296,952,9412491
347,2021-11-26 15:00:00,5663,4311245,3984.0,3807680,16136.0,997814,153.0,321753.0,5816,4632998,4137,4129433,25936,9438427
348,2021-11-27 15:00:00,3771,4315016,5497.0,3813177,11350.0,1009164,134.0,321887.0,3905,4636903,5631,4135064,20752,9459179
349,2021-11-28 15:00:00,2394,4317410,6425.0,3819602,7773.0,1016937,77.0,321964.0,2471,4639374,6502,4141566,16669,9475848
350,2021-11-29 15:00:00,6386,4323796,9361.0,3828963,19311.0,1036248,380.0,322344.0,6766,4646140,9741,4151307,35438,9511286
351,2021-11-30 15:00:00,6283,4330079,9376.0,3838339,23432.0,1059680,263.0,322607.0,6546,4652686,9639,4160946,39354,9550640
352,2021-12-01 15:00:00,7350,4337429,9821.0,3848160,26365.0,1086045,314.0,322921.0,7664,4660350,10135,4171081,43850,9594490
353,2021-12-02 15:00:00,6945,4344374,8883.0,3857043,27795.0,1113840,464.0,323385.0,7409,4667759,9347,4180428,44087,9638577
354,2021-12-03 15:00:00,7656,4352030,9397.0,3866440,31396.0,1145236,253.0,323638.0,7909,4675668,9650,4190078,48702,9687279
355,2021-12-04 15:00:00,5936,4357966,10198.0,3876638,17318.0,1162554,467.0,324105.0,6403,4682071,10665,4200743,33919,9721198
356,2021-12-05 15:00:00,3435,4361401,3588.0,3880226,10014.0,1172568,79.0,324184.0,3514,4685585,3667,4204410,17116,9738314
357,2021-12-06 15:00:00,6773,4368174,7132.0,3887358,25143.0,1197711,295.0,324479.0,7068,4692653,7427,4211837,39343,9777657
358,2021-12-07 15:00:00,6453,4374627,7094.0,3894452,26089.0,1223800,255.0,324734.0,6708,4699361,7349,4219186,39891,9817548
359,2021-12-08 15:00:00,6926,4381553,7442.0,3901894,25280.0,1249080,317.0,325051.0,7243,4706604,7759,4226945,39965,9857513
360,2021-12-09 15:00:00,6550,4388103,7070.0,3908964,26085.0,1275165,413.0,325464.0,6963,4713567,7483,4234428,40118,9897631
361,2021-12-10 15:00:00,7285,4395388,7373.0,3916337,27649.0,1302814,267.0,325731.0,7552,4721119,7640,4242068,42574,9940205
362,2021-12-11 15:00:00,4452,4399840,7717.0,3924054,14931.0,1317745,332.0,326063.0,4784,4725903,8049,4250117,27432,9967637
363,2021-12-12 15:00:00,3999,4403839,2819.0,3926873,8206.0,1325951,65.0,326128.0,4064,4729967,2884,4253001,15089,9982726
364,2021-12-13 15:00:00,5781,4409620,5840.0,3932713,22857.0,1348808,243.0,326371.0,6024,4735991,6083,4259084,34721,10017447
365,2021-12-14 15:00:00,6454,4416074,5960.0,3938673,24288.0,1373096,223.0,326594.0,6677,4742668,6183,4265267,36925,10054372
366,2021-12-15 15:00:00,7188,4423262,5752.0,3944425,22712.0,1395808,257.0,326851.0,7445,4750113,6009,4271276,35909,10090281
367,2021-12-16 15:00:00,7882,4431144,2845.0,3947270,26110.0,1421918,424.0,327275.0,8306,4758419,3269,4274545,37261,10127542
368,2021-12-17 15:00:00,7859,4439003,4196.0,3951466,27347.0,1449265,195.0,327470.0,8054,4766473,4391,4278936,39597,10167139
369,2021-12-18 15:00:00,5865,4444868,3220.0,3954686,16081.0,1465346,298.0,327768.0,6163,4772636,3518,4282454,25464,10192603
370,2021-12-19 15:00:00,3374,4448242,1344.0,3956030,9895.0,1475241,37.0,327805.0,3411,4776047,1381,4283835,14650,10207253
371,2021-12-20 15:00:00,8096,4456338,3767.0,3959797,27429.0,1502670,172.0,327977.0,8268,4784315,3939,4287774,39464,10246717
372,2021-12-21 15:00:00,9074,4465412,4227.0,3964024,28050.0,1530720,185.0,328162.0,9259,4793574,4412,4292186,41536,10288253
373,2021-12-22 15:00:00,8733,4474145,3923.0,3967947,28018.0,1558738,188.0,328350.0,8921,4802495,4111,4296297,40862,10329115
374,2021-12-23 15:00:00,8438,4482583,3606.0,3971553,23662.0,1582400,359.0,328709.0,8797,4811292,3965,4300262,36065,10365180
375,2021-12-24 15:00:00,1633,4484216,1017.0,3972570,4780.0,1587180,39.0,328748.0,1672,4812964,1056,4301318,7469,10372649
376,2021-12-25 15:00:00,48,4484264,37.0,3972607,285.0,1587465,1.0,328749.0,49,4813013,38,4301356,371,10373020
377,2021-12-26 15:00:00,2518,4486782,1754.0,3974361,7117.0,1594582,44.0,328793.0,2562,4815575,1798,4303154,11433,10384453
378,2021-12-27 15:00:00,7248,4494030,4060.0,3978421,21354.0,1615936,297.0,329090.0,7545,4823120,4357,4307511,32959,10417412
379,2021-12-28 15:00:00,7973,4502003,3879.0,3982300,24215.0,1640151,179.0,329269.0,8152,4831272,4058,4311569,36246,10453658
380,2021-12-29 15:00:00,8264,4510267,4043.0,3986343,22916.0,1663067,154.0,329423.0,8418,4839690,4197,4315766,35377,10489035
381,2021-12-30 15:00:00,7483,4517750,3814.0,3990157,21487.0,1684554,290.0,329713.0,7773,4847463,4104,4319870,33074,10522109
382,2021-12-31 15:00:00,2599,4520349,1547.0,3991704,7319.0,1691873,91.0,329804.0,2690,4850153,1638,4321508,11556,10533665
383,2022-01-01 15:00:00,754,4521103,355.0,3992059,1878.0,1693751,34.0,329838.0,788,4850941,389,4321897,3021,10536686
384,2022-01-02 15:00:00,2217,4523320,1655.0,3993714,5522.0,1699273,49.0,329887.0,2266,4853207,1704,4323601,9443,10546129
385,2022-01-03 15:00:00,3395,4526715,2098.0,3995812,10755.0,1710028,224.0,330111.0,3619,4856826,2322,4325923,16472,10562601
386,2022-01-04 15:00:00,5859,4532574,3533.0,3999345,15972.0,1726000,165.0,330276.0,6024,4862850,3698,4329621,25529,10588130
387,2022-01-05 15:00:00,6830,4539404,4726.0,4004071,18059.0,1744059,176.0,330452.0,7006,4869856,4902,4334523,29791,10617921
388,2022-01-06 15:00:00,6823,4546227,4883.0,4008954,22236.0,1766295,267.0,330719.0,7090,4876946,5150,4339673,34209,10652130
389,2022-01-07 15:00:00,6030,4552257,3855.0,4012809,19495.0,1785790,163.0,330882.0,6193,4883139,4018,4343691,29543,10681673
390,2022-01-08 15:00:00,4802,4557059,3949.0,4016758,13234.0,1799024,78.0,330960.0,4880,4888019,4027,4347718,22063,10703736
391,2022-01-09 15:00:00,2761,4559820,2028.0,4018786,7543.0,1806567,154.0,331114.0,2915,4890934,2182,4349900,12486,10716222
392,2022-01-10 15:00:00,6350,4566170,3898.0,4022684,18664.0,1825231,160.0,331274.0,6510,4897444,4058,4353958,29072,10745294
393,2022-01-11 15:00:00,6534,4572704,4314.0,4026998,17981.0,1843212,143.0,331417.0,6677,4904121,4457,4358415,28972,10774266
394,2022-01-12 15:00:00,6824,4579528,4472.0,4031470,18514.0,1861726,223.0,331640.0,7047,4911168,4695,4363110,30033,10804299
395,2022-01-13 15:00:00,6703,4586231,4410.0,4035880,17260.0,1878986,152.0,331792.0,6855,4918023,4562,4367672,28525,10832824
396,2022-01-14 15:00:00,7264,4593495,3326.0,4039206,21949.0,1900935,254.0,332046.0,7518,4925541,3580,4371252,32793,10865617
397,2022-01-15 15:00:00,4293,4597788,1699.0,4040905,11540.0,1912475,71.0,332117.0,4364,4929905,1770,4373022,17603,10883220
398,2022-01-16 15:00:00,2213,4600001,1324.0,4042229,6209.0,1918684,116.0,332233.0,2329,4932234,1440,4374462,9862,10893082
399,2022-01-17 15:00:00,3642,4603643,2407.0,4044636,10135.0,1928819,74.0,332307.0,3716,4935950,2481,4376943,16258,10909340
400,2022-01-18 15:00:00,5282,4608925,4251.0,4048887,13230.0,1942049,103.0,332410.0,5385,4941335,4354,4381297,22866,10932206
401,2022-01-19 15:00:00,5305,4614230,4500.0,4053387,13218.0,1955267,99.0,332509.0,5404,4946739,4599,4385896,23122,10955328
402,2022-01-20 15:00:00,4543,4618773,3648.0,4057035,11798.0,1967065,176.0,332685.0,4719,4951458,3824,4389720,20165,10975493
403,2022-01-21 15:00:00,5597,4624370,2962.0,4059997,14933.0,1981998,126.0,332811.0,5723,4957181,3088,4392808,23618,10999111
404,2022-01-22 15:00:00,3468,4627838,1732.0,4061729,8975.0,1990973,134.0,332945.0,3602,4960783,1866,4394674,14309,11013420
405,2022-01-23 15:00:00,2052,4629890,1503.0,4063232,5761.0,1996734,30.0,332975.0,2082,4962865,1533,4396207,9346,11022766
406,2022-01-24 15:00:00,4134,4634024,2780.0,4066012,11385.0,2008119,90.0,333065.0,4224,4967089,2870,4399077,18389,11041155
407,2022-01-25 15:00:00,3848,4637872,3339.0,4069351,9282.0,2017401,94.0,333159.0,3942,4971031,3433,4402510,16563,11057718
408,2022-01-26 15:00:00,3888,4641760,3723.0,4073074,9135.0,2026536,96.0,333255.0,3984,4975015,3819,4406329,16842,11074560
409,2022-01-27 15:00:00,3789,4645549,3982.0,4077056,10299.0,2036835,188.0,333443.0,3977,4978992,4170,4410499,18258,11092818
410,2022-01-28 15:00:00,3871,4649420,3305.0,4080361,11322.0,2048157,76.0,333519.0,3947,4982939,3381,4413880,18574,11111392
411,2022-01-29 15:00:00,2303,4651723,2304.0,4082665,5907.0,2054064,117.0,333636.0,2420,4985359,2421,4416301,10631,11122023
412,2022-01-30 15:00:00,1555,4653278,1658.0,4084323,3778.0,2057842,16.0,333652.0,1571,4986930,1674,4417975,7007,11129030
413,2022-01-31 15:00:00,2999,4656277,3263.0,4087586,7661.0,2065503,58.0,333710.0,3057,4989987,3321,4421296,13981,11143011
414,2022-02-01 15:00:00,2646,4658923,3433.0,4091019,6831.0,2072334,75.0,333785.0,2721,4992708,3508,4424804,12985,11155996
415,2022-02-02 15:00:00,2830,4661753,3738.0,4094757,6639.0,2078973,79.0,333864.0,2909,4995617,3817,4428621,13286,11169282
416,2022-02-03 15:00:00,2764,4664517,3700.0,4098457,6919.0,2085892,42.0,333906.0,2806,4998423,3742,4432363,13425,11182707
417,2022-02-04 15:00:00,2789,4667306,4428.0,4102885,7789.0,2093681,127.0,334033.0,2916,5001339,4555,4436918,15133,11197840
418,2022-02-05 15:00:00,1921,4669227,2912.0,4105797,5049.0,2098730,112.0,334145.0,2033,5003372,3024,4439942,9994,11207834
419,2022-02-06 15:00:00,1074,4670301,1357.0,4107154,2483.0,2101213,24.0,334169.0,1098,5004470,1381,4441323,4938,11212772
420,2022-02-07 15:00:00,2085,4672386,2720.0,4109874,5260.0,2106473,51.0,334220.0,2136,5006606,2771,4444094,10116,11222888
421,2022-02-08 15:00:00,2096,4674482,3115.0,4112989,5257.0,2111730,63.0,334283.0,2159,5008765,3178,4447272,10531,11233419
422,2022-02-09 15:00:00,2202,4676684,3338.0,4116327,5891.0,2117621,80.0,334363.0,2282,5011047,3418,4450690,11511,11244930
423,2022-02-10 15:00:00,2111,4678795,2897.0,4119224,5864.0,2123485,55.0,334418.0,2166,5013213,2952,4453642,10927,11255857
424,2022-02-11 15:00:00,2531,4681326,3544.0,4122768,7673.0,2131158,126.0,334544.0,2657,5015870,3670,4457312,13874,11269731
425,2022-02-12 15:00:00,1693,4683019,2347.0,4125115,4572.0,2135730,96.0,334640.0,1789,5017659,2443,4459755,8708,11278439
426,2022-02-13 15:00:00,735,4683754,1090.0,4126205,1828.0,2137558,17.0,334657.0,752,5018411,1107,4460862,3670,11282109
427,2022-02-14 15:00:00,1507,4685261,2265.0,4128470,4059.0,2141617,87.0,334744.0,1594,5020005,2352,4463214,7918,11290027
428,2022-02-15 15:00:00,1960,4687221,2496.0,4130966,4040.0,2145657,52.0,334796.0,2012,5022017,2548,4465762,8548,11298575
429,2022-02-16 15:00:00,1697,4688918,2477.0,4133443,4042.0,2149699,52.0,334848.0,1749,5023766,2529,4468291,8268,11306843
430,2022-02-17 15:00:00,16885,4705803,13077.0,4146520,3867.0,2153566,488.0,335336.0,17373,5041139,13565,4481856,34317,11341160
431,2022-02-18 15:00:00,2034,4707837,2630.0,4149150,4869.0,2158435,51.0,335387.0,2085,5043224,2681,4484537,9584,11350744
432,2022-02-19 15:00:00,1245,4709082,1727.0,4150877,3040.0,2161475,39.0,335426.0,1284,5044508,1766,4486303,6051,11356795
433,2022-02-20 15:00:00,722,4709804,857.0,4151734,1762.0,2163237,16.0,335442.0,738,5045246,873,4487176,3357,11360152
434,2022-02-21 15:00:00,1325,4711129,1800.0,4153534,3071.0,2166308,34.0,335476.0,1359,5046605,1834,4489010,6230,11366382
435,2022-02-22 15:00:00,1497,4712626,1971.0,4155505,3178.0,2169486,37.0,335513.0,1534,5048139,2008,4491018,6683,11373065
436,2022-02-23 15:00:00,1601,4714227,1952.0,4157457,3313.0,2172799,38.0,335551.0,1639,5049778,1990,4493008,6904,11379969
437,2022-02-24 15:00:00,1564,4715791,1738.0,4159195,3066.0,2175865,39.0,335590.0,1603,5051381,1777,4494785,6407,11386376
438,2022-02-25 15:00:00,1741,4717532,1922.0,4161117,4231.0,2180096,76.0,335666.0,1817,5053198,1998,4496783,7970,11394346
439,2022-02-26 15:00:00,1219,4718751,1270.0,4162387,2741.0,2182837,46.0,335712.0,1265,5054463,1316,4498099,5276,11399622
440,2022-02-27 15:00:00,597,4719348,543.0,4162930,1386.0,2184223,15.0,335727.0,612,5055075,558,4498657,2541,11402163
441,2022-02-28 15:00:00,1323,4720671,1404.0,4164334,3125.0,2187348,36.0,335763.0,1359,5056434,1440,4500097,5888,11408051
442,2022-03-01 15:00:00,1409,4722080,1408.0,4165742,2959.0,2190307,29.0,335792.0,1438,5057872,1437,4501534,5805,11413856
443,2022-03-02 15:00:00,1227,4723307,1380.0,4167122,3128.0,2193435,69.0,335861.0,1296,5059168,1449,4502983,5804,11419660
444,2022-03-03 15:00:00,1315,4724622,1333.0,4168455,2762.0,2196197,33.0,335894.0,1348,5060516,1366,4504349,5443,11425103
445,2022-03-04 15:00:00,1503,4726125,1615.0,4170070,3755.0,2199952,46.0,335940.0,1549,5062065,1661,4506010,6919,11432022
446,2022-03-05 15:00:00,839,4726964,937.0,4171007,1998.0,2201950,26.0,335966.0,865,5062930,963,4506973,3800,11435822
447,2022-03-06 15:00:00,459,4727423,501.0,4171508,997.0,2202947,10.0,335976.0,469,5063399,511,4507484,1967,11437789
448,2022-03-07 15:00:00,956,4728379,887.0,4172395,2318.0,2205265,27.0,336003.0,983,5064382,914,4508398,4188,11441977
449,2022-03-08 15:00:00,1111,4729490,1041.0,4173436,2536.0,2207801,28.0,336031.0,1139,5065521,1069,4509467,4716,11446693
450,2022-03-09 15:00:00,988,4730478,1059.0,4174495,2284.0,2210085,39.0,336070.0,1027,5066548,1098,4510565,4370,11451063
451,2022-03-10 15:00:00,968,4731446,1034.0,4175529,2211.0,2212296,22.0,336092.0,990,5067538,1056,4511621,4235,11455298
452,2022-03-11 15:00:00,1198,4732644,1478.0,4177007,2994.0,2215290,52.0,336144.0,1250,5068788,1530,4513151,5722,11461020
453,2022-03-12 15:00:00,471,4733115,597.0,4177604,1127.0,2216417,12.0,336156.0,483,5069271,609,4513760,2207,11463227
454,2022-03-13 15:00:00,416,4733531,497.0,4178101,818.0,2217235,7.0,336163.0,423,5069694,504,4514264,1738,11464965
455,2022-03-14 15:00:00,840,4734371,740.0,4178841,1706.0,2218941,22.0,336185.0,862,5070556,762,4515026,3308,11468273
456,2022-03-15 15:00:00,882,4735253,909.0,4179750,1913.0,2220854,13.0,336198.0,895,5071451,922,4515948,3717,11471990
457,2022-03-16 15:00:00,945,4736198,981.0,4180731,1948.0,2222802,28.0,336226.0,973,5072424,1009,4516957,3902,11475892
458,2022-03-17 15:00:00,824,4737022,897.0,4181628,1864.0,2224666,27.0,336253.0,851,5073275,924,4517881,3612,11479504
459,2022-03-18 15:00:00,1068,4738090,1096.0,4182724,2485.0,2227151,35.0,336288.0,1103,5074378,1131,4519012,4684,11484188
460,2022-03-19 15:00:00,587,4738677,671.0,4183395,1396.0,2228547,21.0,336309.0,608,5074986,692,4519704,2675,11486863
461,2022-03-20 15:00:00,361,4739038,366.0,4183761,756.0,2229303,7.0,336316.0,368,5075354,373,4520077,1490,11488353
462,2022-03-21 15:00:00,758,4739796,726.0,4184487,1792.0,2231095,18.0,336334.0,776,5076130,744,4520821,3294,11491647
463,2022-03-22 15:00:00,804,4740600,938.0,4185425,2047.0,2233142,14.0,336348.0,818,5076948,952,4521773,3803,11495450
464,2022-03-23 15:00:00,816,4741416,866.0,4186291,2140.0,2235282,27.0,336375.0,843,5077791,893,4522666,3849,11499299
465,2022-03-24 15:00:00,787,4742203,938.0,4187229,1846.0,2237128,34.0,336409.0,821,5078612,972,4523638,3605,11502904
466,2022-03-25 15:00:00,814,4743017,954.0,4188183,2331.0,2239459,31.0,336440.0,845,5079457,985,4524623,4130,11507034
467,2022-03-26 15:00:00,507,4743524,506.0,4188689,1405.0,2240864,20.0,336460.0,527,5079984,526,4525149,2438,11509472
468,2022-03-27 15:00:00,94,4743618,99.0,4188788,269.0,2241133,6.0,336466.0,100,5080084,105,4525254,468,11509940
