,VACCINATION_DATE,FirstDailyDose,FirstDoseCumulative,SecondDailyDose,SecondDoseCumulative,AdditionalDailyDose,AdditionalDoseCumulative,SingleDailyDose,SingleDoseCumulative,AtleastOneVaccine,AtleastOneVaccineCumulative,CompletedVax,CompletedVaxCumulative,FirstSecondSingleVaccinations,FirstSecondSingleVaccinationsCumulative
0,2020-12-14,19,1491,,535,,,,,19,1491,0,535,19,1963
1,2020-12-15,62,1553,3.0,538,,,,,62,1553,3,538,65,2028
2,2020-12-16,597,2150,5.0,543,,,,,597,2150,5,543,602,2630
3,2020-12-17,1171,3321,8.0,551,,,,,1171,3321,8,551,1179,3809
4,2020-12-18,3032,6353,12.0,563,,,,,3032,6353,12,563,3044,6853
5,2020-12-19,930,7283,7.0,570,,,,,930,7283,7,570,937,7790
6,2020-12-20,370,7653,6.0,576,,,,,370,7653,6,576,376,8166
7,2020-12-21,3901,11554,27.0,603,,,,,3901,11554,27,603,3928,12094
8,2020-12-22,6329,17883,30.0,633,,,,,6329,17883,30,633,6359,18453
9,2020-12-23,5796,23679,41.0,674,,,,,5796,23679,41,674,5837,24290
10,2020-12-24,2730,26409,15.0,689,,,,,2730,26409,15,689,2745,27035
11,2020-12-25,1035,27444,4.0,693,,,,,1035,27444,4,693,1039,28074
12,2020-12-26,1887,29331,10.0,703,,,,,1887,29331,10,703,1897,29971
13,2020-12-27,1804,31135,12.0,715,,,,,1804,31135,12,715,1816,31787
14,2020-12-28,8997,40132,52.0,767,,,,,8997,40132,52,767,9049,40836
15,2020-12-29,10980,51112,54.0,821,,,,,10980,51112,54,821,11034,51870
16,2020-12-30,12511,63623,98.0,919,,,,,12511,63623,98,919,12609,64479
17,2020-12-31,7563,71186,48.0,967,,,,,7563,71186,48,967,7611,72090
18,2021-01-01,3419,74605,145.0,1112,,,,,3419,74605,145,1112,3564,75654
19,2021-01-02,3064,77669,34.0,1146,,,,,3064,77669,34,1146,3098,78752
20,2021-01-03,3418,81087,82.0,1228,,,,,3418,81087,82,1228,3500,82252
21,2021-01-04,13379,94466,343.0,1571,,,,,13379,94466,343,1571,13722,95974
22,2021-01-05,12497,106963,550.0,2121,,,,,12497,106963,550,2121,13047,109021
23,2021-01-06,15286,122249,871.0,2992,,,,,15286,122249,871,2992,16157,125178
24,2021-01-07,15054,137303,1790.0,4782,,,,,15054,137303,1790,4782,16844,142022
25,2021-01-08,24032,161335,2796.0,7578,,,,,24032,161335,2796,7578,26828,168850
26,2021-01-09,5188,166523,960.0,8538,,,,,5188,166523,960,8538,6148,174998
27,2021-01-10,2988,169511,389.0,8927,,,,,2988,169511,389,8927,3377,178375
28,2021-01-11,13749,183260,3488.0,12415,,,,,13749,183260,3488,12415,17237,195612
29,2021-01-12,17410,200670,5600.0,18015,,,,,17410,200670,5600,18015,23010,218622
30,2021-01-13,18638,219308,3942.0,21957,,,,,18638,219308,3942,21957,22580,241202
31,2021-01-14,17882,237190,1969.0,23926,,,,,17882,237190,1969,23926,19851,261053
32,2021-01-15,19515,256705,2041.0,25967,,,,,19515,256705,2041,25967,21556,282609
33,2021-01-16,5849,262554,1625.0,27592,,,,,5849,262554,1625,27592,7474,290083
34,2021-01-17,2129,264683,1480.0,29072,,,,,2129,264683,1480,29072,3609,293692
35,2021-01-18,7090,271773,3269.0,32341,,,,,7090,271773,3269,32341,10359,304051
36,2021-01-19,16965,288738,5421.0,37762,,,,,16965,288738,5421,37762,22386,326437
37,2021-01-20,21028,309766,5339.0,43101,,,,,21028,309766,5339,43101,26367,352804
38,2021-01-21,23837,333603,3875.0,46976,,,,,23837,333603,3875,46976,27712,380516
39,2021-01-22,28680,362283,3774.0,50750,,,,,28680,362283,3774,50750,32454,412970
40,2021-01-23,10133,372416,1949.0,52699,,,,,10133,372416,1949,52699,12082,425052
41,2021-01-24,3362,375778,1727.0,54426,,,,,3362,375778,1727,54426,5089,430141
42,2021-01-25,16317,392095,8627.0,63053,,,,,16317,392095,8627,63053,24944,455085
43,2021-01-26,17574,409669,8985.0,72038,,,,,17574,409669,8985,72038,26559,481644
44,2021-01-27,24448,434117,12586.0,84624,,,,,24448,434117,12586,84624,37034,518678
45,2021-01-28,22668,456785,9347.0,93971,,,,,22668,456785,9347,93971,32015,550693
46,2021-01-29,24800,481585,7944.0,101915,,,,,24800,481585,7944,101915,32744,583437
47,2021-01-30,17798,499383,2572.0,104487,,,,,17798,499383,2572,104487,20370,603807
48,2021-01-31,3768,503151,1376.0,105863,,,,,3768,503151,1376,105863,5144,608951
49,2021-02-01,8212,511363,5443.0,111306,,,,,8212,511363,5443,111306,13655,622606
50,2021-02-02,12531,523894,13848.0,125154,,,,,12531,523894,13848,125154,26379,648985
51,2021-02-03,18282,542176,18157.0,143311,,,,,18282,542176,18157,143311,36439,685424
52,2021-02-04,22154,564330,15807.0,159118,,,,,22154,564330,15807,159118,37961,723385
53,2021-02-05,20426,584756,17456.0,176574,,,,,20426,584756,17456,176574,37882,761267
54,2021-02-06,11388,596144,14543.0,191117,,,,,11388,596144,14543,191117,25931,787198
55,2021-02-07,5994,602138,1953.0,193070,,,,,5994,602138,1953,193070,7947,795145
56,2021-02-08,13023,615161,12990.0,206060,,,,,13023,615161,12990,206060,26013,821158
57,2021-02-09,16674,631835,13897.0,219957,,,,,16674,631835,13897,219957,30571,851729
58,2021-02-10,19338,651173,21330.0,241287,,,,,19338,651173,21330,241287,40668,892397
59,2021-02-11,22951,674124,17396.0,258683,,,,,22951,674124,17396,258683,40347,932744
60,2021-02-12,20449,694573,19687.0,278370,,,,,20449,694573,19687,278370,40136,972880
61,2021-02-13,11476,706049,6434.0,284804,,,,,11476,706049,6434,284804,17910,990790
62,2021-02-14,7122,713171,2142.0,286946,,,,,7122,713171,2142,286946,9264,1000054
63,2021-02-15,11773,724944,13356.0,300302,,,,,11773,724944,13356,300302,25129,1025183
64,2021-02-16,16658,741602,21045.0,321347,,,,,16658,741602,21045,321347,37703,1062886
65,2021-02-17,20692,762294,26401.0,347748,,,,,20692,762294,26401,347748,47093,1109979
66,2021-02-18,3207,765501,4633.0,352381,,,,,3207,765501,4633,352381,7840,1117819
67,2021-02-19,10269,775770,19947.0,372328,,,,,10269,775770,19947,372328,30216,1148035
68,2021-02-20,10323,786093,20326.0,392654,,,,,10323,786093,20326,392654,30649,1178684
69,2021-02-21,6195,792288,7673.0,400327,,,,,6195,792288,7673,400327,13868,1192552
70,2021-02-22,8051,800339,15504.0,415831,,,,,8051,800339,15504,415831,23555,1216107
71,2021-02-23,15544,815883,15993.0,431824,,,,,15544,815883,15993,431824,31537,1247644
72,2021-02-24,18008,833891,24854.0,456678,,,,,18008,833891,24854,456678,42862,1290506
73,2021-02-25,20407,854298,26604.0,483282,,,,,20407,854298,26604,483282,47011,1337517
74,2021-02-26,26701,880999,26289.0,509571,,,,,26701,880999,26289,509571,52990,1390507
75,2021-02-27,16034,897033,11170.0,520741,,,,,16034,897033,11170,520741,27204,1417711
76,2021-02-28,15528,912561,4898.0,525639,,,,,15528,912561,4898,525639,20426,1438137
77,2021-03-01,27308,939869,12702.0,538341,,,,,27308,939869,12702,538341,40010,1478147
78,2021-03-02,24011,963880,13312.0,551653,,,38.0,38.0,24049,963918,13350,551691,37361,1515508
79,2021-03-03,30261,994141,18435.0,570088,,,194.0,232.0,30455,994373,18629,570320,48890,1564398
80,2021-03-04,31024,1025165,18260.0,588348,,,4067.0,4299.0,35091,1029464,22327,592647,53351,1617749
81,2021-03-05,30107,1055272,19795.0,608143,,,4913.0,9212.0,35020,1064484,24708,617355,54815,1672564
82,2021-03-06,19009,1074281,9540.0,617683,,,6010.0,15222.0,25019,1089503,15550,632905,34559,1707123
83,2021-03-07,12157,1086438,4932.0,622615,,,6605.0,21827.0,18762,1108265,11537,644442,23694,1730817
84,2021-03-08,25935,1112373,8870.0,631485,,,8276.0,30103.0,34211,1142476,17146,661588,43081,1773898
85,2021-03-09,26158,1138531,15509.0,646994,,,8346.0,38449.0,34504,1176980,23855,685443,50013,1823911
86,2021-03-10,29899,1168430,16063.0,663057,,,7937.0,46386.0,37836,1214816,24000,709443,53899,1877810
87,2021-03-11,36028,1204458,16436.0,679493,,,3982.0,50368.0,40010,1254826,20418,729861,56446,1934256
88,2021-03-12,36928,1241386,18167.0,697660,,,2929.0,53297.0,39857,1294683,21096,750957,58024,1992280
89,2021-03-13,22675,1264061,10347.0,708007,,,1631.0,54928.0,24306,1318989,11978,762935,34653,2026933
90,2021-03-14,17845,1281906,6740.0,714747,,,1010.0,55938.0,18855,1337844,7750,770685,25595,2052528
91,2021-03-15,29904,1311810,11379.0,726126,,,599.0,56537.0,30503,1368347,11978,782663,41882,2094410
92,2021-03-16,33493,1345303,13597.0,739723,,,772.0,57309.0,34265,1402612,14369,797032,47862,2142272
93,2021-03-17,37649,1382952,17092.0,756815,,,1183.0,58492.0,38832,1441444,18275,815307,55924,2198196
94,2021-03-18,41483,1424435,12714.0,769529,,,1353.0,59845.0,42836,1484280,14067,829374,55550,2253746
95,2021-03-19,38393,1462828,15448.0,784977,,,1046.0,60891.0,39439,1523719,16494,845868,54887,2308633
96,2021-03-20,24745,1487573,10236.0,795213,,,705.0,61596.0,25450,1549169,10941,856809,35686,2344319
97,2021-03-21,19208,1506781,7914.0,803127,,,342.0,61938.0,19550,1568719,8256,865065,27464,2371783
98,2021-03-22,32613,1539394,11526.0,814653,,,835.0,62773.0,33448,1602167,12361,877426,44974,2416757
99,2021-03-23,38416,1577810,17885.0,832538,,,1557.0,64330.0,39973,1642140,19442,896868,57858,2474615
100,2021-03-24,41093,1618903,21270.0,853808,,,1388.0,65718.0,42481,1684621,22658,919526,63751,2538366
101,2021-03-25,42932,1661835,21760.0,875568,,,2455.0,68173.0,45387,1730008,24215,943741,67147,2605513
102,2021-03-26,36397,1698232,26730.0,902298,,,2495.0,70668.0,38892,1768900,29225,972966,65622,2671135
103,2021-03-27,26478,1724710,17335.0,919633,,,2489.0,73157.0,28967,1797867,19824,992790,46302,2717437
104,2021-03-28,17015,1741725,12695.0,932328,,,1615.0,74772.0,18630,1816497,14310,1007100,31325,2748762
105,2021-03-29,29727,1771452,26405.0,958733,,,1142.0,75914.0,30869,1847366,27547,1034647,57274,2806036
106,2021-03-30,40084,1811536,29105.0,987838,,,1865.0,77779.0,41949,1889315,30970,1065617,71054,2877090
107,2021-03-31,41032,1852568,34771.0,1022609,,,5749.0,83528.0,46781,1936096,40520,1106137,81552,2958642
108,2021-04-01,42530,1895098,41238.0,1063847,,,5767.0,89295.0,48297,1984393,47005,1153142,89535,3048177
109,2021-04-02,34956,1930054,32755.0,1096602,,,6135.0,95430.0,41091,2025484,38890,1192032,73846,3122023
110,2021-04-03,21186,1951240,19248.0,1115850,,,4395.0,99825.0,25581,2051065,23643,1215675,44829,3166852
111,2021-04-04,8306,1959546,10227.0,1126077,,,968.0,100793.0,9274,2060339,11195,1226870,19501,3186353
112,2021-04-05,27968,1987514,28990.0,1155067,,,6663.0,107456.0,34631,2094970,35653,1262523,63621,3249974
113,2021-04-06,39813,2027327,30534.0,1185601,,,10504.0,117960.0,50317,2145287,41038,1303561,80851,3330825
114,2021-04-07,36121,2063448,34380.0,1219981,,,13000.0,130960.0,49121,2194408,47380,1350941,83501,3414326
115,2021-04-08,42368,2105816,36172.0,1256153,,,13876.0,144836.0,56244,2250652,50048,1400989,92416,3506742
116,2021-04-09,34099,2139915,36379.0,1292532,,,14532.0,159368.0,48631,2299283,50911,1451900,85010,3591752
117,2021-04-10,23510,2163425,23192.0,1315724,,,7642.0,167010.0,31152,2330435,30834,1482734,54344,3646096
118,2021-04-11,17586,2181011,13303.0,1329027,,,10123.0,177133.0,27709,2358144,23426,1506160,41012,3687108
119,2021-04-12,24612,2205623,33297.0,1362324,,,10907.0,188040.0,35519,2393663,44204,1550364,68816,3755924
120,2021-04-13,126187,2331810,91369.0,1453693,,,3293.0,191333.0,129480,2523143,94662,1645026,220849,3976773
121,2021-04-14,40751,2372561,37861.0,1491554,,,213.0,191546.0,40964,2564107,38074,1683100,78825,4055598
122,2021-04-15,41429,2413990,39597.0,1531151,,,176.0,191722.0,41605,2605712,39773,1722873,81202,4136800
123,2021-04-16,37154,2451144,38913.0,1570064,,,25.0,191747.0,37179,2642891,38938,1761811,76092,4212892
124,2021-04-17,32817,2483961,22049.0,1592113,,,13.0,191760.0,32830,2675721,22062,1783873,54879,4267771
125,2021-04-18,20064,2504025,16217.0,1608330,,,5.0,191765.0,20069,2695790,16222,1800095,36286,4304057
126,2021-04-19,29892,2533917,36565.0,1644895,,,60.0,191825.0,29952,2725742,36625,1836720,66517,4370574
127,2021-04-20,32942,2566859,44520.0,1689415,,,59.0,191884.0,33001,2758743,44579,1881299,77521,4448095
128,2021-04-21,39847,2606706,47104.0,1736519,,,26.0,191910.0,39873,2798616,47130,1928429,86977,4535072
129,2021-04-22,35868,2642574,42737.0,1779256,,,16.0,191926.0,35884,2834500,42753,1971182,78621,4613693
130,2021-04-23,33152,2675726,40195.0,1819451,,,14.0,191940.0,33166,2867666,40209,2011391,73361,4687054
131,2021-04-24,26431,2702157,27938.0,1847389,,,81.0,192021.0,26512,2894178,28019,2039410,54450,4741504
132,2021-04-25,20219,2722376,11007.0,1858396,,,31.0,192052.0,20250,2914428,11038,2050448,31257,4772761
133,2021-04-26,27390,2749766,32785.0,1891181,,,201.0,192253.0,27591,2942019,32986,2083434,60376,4833137
134,2021-04-27,26673,2776439,33131.0,1924312,,,1097.0,193350.0,27770,2969789,34228,2117662,60901,4894038
135,2021-04-28,28934,2805373,39589.0,1963901,,,1367.0,194717.0,30301,3000090,40956,2158618,69890,4963928
136,2021-04-29,27071,2832444,39808.0,2003709,,,1463.0,196180.0,28534,3028624,41271,2199889,68342,5032270
137,2021-04-30,28207,2860651,32326.0,2036035,,,1650.0,197830.0,29857,3058481,33976,2233865,62183,5094453
138,2021-05-01,20787,2881438,26840.0,2062875,,,1057.0,198887.0,21844,3080325,27897,2261762,48684,5143137
139,2021-05-02,10274,2891712,17092.0,2079967,,,823.0,199710.0,11097,3091422,17915,2279677,28189,5171326
140,2021-05-03,12729,2904441,28707.0,2108674,,,1917.0,201627.0,14646,3106068,30624,2310301,43353,5214679
141,2021-05-04,13563,2918004,38725.0,2147399,,,1742.0,203369.0,15305,3121373,40467,2350768,54030,5268709
142,2021-05-05,19317,2937321,37805.0,2185204,,,1923.0,205292.0,21240,3142613,39728,2390496,59045,5327754
143,2021-05-06,16931,2954252,40607.0,2225811,,,1722.0,207014.0,18653,3161266,42329,2432825,59260,5387014
144,2021-05-07,17591,2971843,37040.0,2262851,,,1959.0,208973.0,19550,3180816,38999,2471824,56590,5443604
145,2021-05-08,10801,2982644,31242.0,2294093,,,1293.0,210266.0,12094,3192910,32535,2504359,43336,5486940
146,2021-05-09,5077,2987721,12259.0,2306352,,,695.0,210961.0,5772,3198682,12954,2517313,18031,5504971
147,2021-05-10,8961,2996682,31063.0,2337415,,,1362.0,212323.0,10323,3209005,32425,2549738,41386,5546357
148,2021-05-11,12186,3008868,30307.0,2367722,,,1441.0,213764.0,13627,3222632,31748,2581486,43934,5590291
149,2021-05-12,13948,3022816,38653.0,2406375,,,1918.0,215682.0,15866,3238498,40571,2622057,54519,5644810
150,2021-05-13,21845,3044661,33534.0,2439909,,,1347.0,217029.0,23192,3261690,34881,2656938,56726,5701536
151,2021-05-14,24393,3069054,30085.0,2469994,,,1775.0,218804.0,26168,3287858,31860,2688798,56253,5757789
152,2021-05-15,21954,3091008,25133.0,2495127,,,1490.0,220294.0,23444,3311302,26623,2715421,48577,5806366
153,2021-05-16,9093,3100101,17581.0,2512708,,,1115.0,221409.0,10208,3321510,18696,2734117,27789,5834155
154,2021-05-17,16842,3116943,28424.0,2541132,,,1950.0,223359.0,18792,3340302,30374,2764491,47216,5881371
155,2021-05-18,21263,3138206,30706.0,2571838,,,1943.0,225302.0,23206,3363508,32649,2797140,53912,5935283
156,2021-05-19,27675,3165881,32455.0,2604293,,,1632.0,226934.0,29307,3392815,34087,2831227,61762,5997045
157,2021-05-20,20815,3186696,33290.0,2637583,,,1965.0,228899.0,22780,3415595,35255,2866482,56070,6053115
158,2021-05-21,19167,3205863,30379.0,2667962,,,1609.0,230508.0,20776,3436371,31988,2898470,51155,6104270
159,2021-05-22,16955,3222818,20708.0,2688670,,,1269.0,231777.0,18224,3454595,21977,2920447,38932,6143202
160,2021-05-23,8812,3231630,11458.0,2700128,,,965.0,232742.0,9777,3464372,12423,2932870,21235,6164437
161,2021-05-24,13574,3245204,17790.0,2717918,,,1473.0,234215.0,15047,3479419,19263,2952133,32837,6197274
162,2021-05-25,13078,3258282,18723.0,2736641,,,1328.0,235543.0,14406,3493825,20051,2972184,33129,6230403
163,2021-05-26,18368,3276650,19701.0,2756342,,,1512.0,237055.0,19880,3513705,21213,2993397,39581,6269984
164,2021-05-27,11699,3288349,18714.0,2775056,,,1120.0,238175.0,12819,3526524,19834,3013231,31533,6301517
165,2021-05-28,12418,3300767,19869.0,2794925,,,1402.0,239577.0,13820,3540344,21271,3034502,33689,6335206
166,2021-05-29,9516,3310283,11737.0,2806662,,,937.0,240514.0,10453,3550797,12674,3047176,22190,6357396
167,2021-05-30,4967,3315250,6446.0,2813108,,,596.0,241110.0,5563,3556360,7042,3054218,12009,6369405
168,2021-05-31,1779,3317029,3715.0,2816823,,,305.0,241415.0,2084,3558444,4020,3058238,5799,6375204
169,2021-06-01,9888,3326917,16507.0,2833330,,,1162.0,242577.0,11050,3569494,17669,3075907,27557,6402761
170,2021-06-02,10235,3337152,16838.0,2850168,,,962.0,243539.0,11197,3580691,17800,3093707,28035,6430796
171,2021-06-03,7899,3345051,21223.0,2871391,,,1089.0,244628.0,8988,3589679,22312,3116019,30211,6461007
172,2021-06-04,8197,3353248,22378.0,2893769,,,1121.0,245749.0,9318,3598997,23499,3139518,31696,6492703
173,2021-06-05,6998,3360246,19477.0,2913246,,,721.0,246470.0,7719,3606716,20198,3159716,27196,6519899
174,2021-06-06,3457,3363703,7264.0,2920510,,,426.0,246896.0,3883,3610599,7690,3167406,11147,6531046
175,2021-06-07,6862,3370565,15805.0,2936315,,,726.0,247622.0,7588,3618187,16531,3183937,23393,6554439
176,2021-06-08,6672,3377237,19747.0,2956062,,,831.0,248453.0,7503,3625690,20578,3204515,27250,6581689
177,2021-06-09,8198,3385435,24026.0,2980088,,,969.0,249422.0,9167,3634857,24995,3229510,33193,6614882
178,2021-06-10,7157,3392592,19152.0,2999240,,,895.0,250317.0,8052,3642909,20047,3249557,27204,6642086
179,2021-06-11,7493,3400085,17743.0,3016983,,,1126.0,251443.0,8619,3651528,18869,3268426,26362,6668448
180,2021-06-12,5244,3405329,14787.0,3031770,,,605.0,252048.0,5849,3657377,15392,3283818,20636,6689084
181,2021-06-13,1947,3407276,7639.0,3039409,,,427.0,252475.0,2374,3659751,8066,3291884,10013,6699097
182,2021-06-14,5656,3412932,11839.0,3051248,,,734.0,253209.0,6390,3666141,12573,3304457,18229,6717326
183,2021-06-15,5652,3418584,14358.0,3065606,,,873.0,254082.0,6525,3672666,15231,3319688,20883,6738209
184,2021-06-16,8732,3427316,21639.0,3087245,,,758.0,254840.0,9490,3682156,22397,3342085,31129,6769338
185,2021-06-17,6686,3434002,12387.0,3099632,,,720.0,255560.0,7406,3689562,13107,3355192,19793,6789131
186,2021-06-18,6838,3440840,12753.0,3112385,,,703.0,256263.0,7541,3697103,13456,3368648,20294,6809425
187,2021-06-19,4655,3445495,9391.0,3121776,,,614.0,256877.0,5269,3702372,10005,3378653,14660,6824085
188,2021-06-20,2513,3448008,5068.0,3126844,,,377.0,257254.0,2890,3705262,5445,3384098,7958,6832043
189,2021-06-21,5568,3453576,5343.0,3132187,,,636.0,257890.0,6204,3711466,5979,3390077,11547,6843590
190,2021-06-22,5351,3458927,9066.0,3141253,,,699.0,258589.0,6050,3717516,9765,3399842,15116,6858706
191,2021-06-23,6066,3464993,10361.0,3151614,,,645.0,259234.0,6711,3724227,11006,3410848,17072,6875778
192,2021-06-24,5932,3470925,8221.0,3159835,,,595.0,259829.0,6527,3730754,8816,3419664,14748,6890526
193,2021-06-25,5831,3476756,8672.0,3168507,,,619.0,260448.0,6450,3737204,9291,3428955,15122,6905648
194,2021-06-26,3707,3480463,6305.0,3174812,,,398.0,260846.0,4105,3741309,6703,3435658,10410,6916058
195,2021-06-27,2810,3483273,3525.0,3178337,,,185.0,261031.0,2995,3744304,3710,3439368,6520,6922578
196,2021-06-28,4928,3488201,6399.0,3184736,,,539.0,261570.0,5467,3749771,6938,3446306,11866,6934444
197,2021-06-29,5064,3493265,6490.0,3191226,,,524.0,262094.0,5588,3755359,7014,3453320,12078,6946522
198,2021-06-30,5639,3498904,7396.0,3198622,,,607.0,262701.0,6246,3761605,8003,3461323,13642,6960164
199,2021-07-01,5452,3504356,7009.0,3205631,,,505.0,263206.0,5957,3767562,7514,3468837,12966,6973130
200,2021-07-02,5306,3509662,6863.0,3212494,,,527.0,263733.0,5833,3773395,7390,3476227,12696,6985826
201,2021-07-03,3276,3512938,4076.0,3216570,,,264.0,263997.0,3540,3776935,4340,3480567,7616,6993442
202,2021-07-04,494,3513432,551.0,3217121,,,69.0,264066.0,563,3777498,620,3481187,1114,6994556
203,2021-07-05,3773,3517205,3955.0,3221076,,,287.0,264353.0,4060,3781558,4242,3485429,8015,7002571
204,2021-07-06,4493,3521698,6296.0,3227372,,,455.0,264808.0,4948,3786506,6751,3492180,11244,7013815
205,2021-07-07,4469,3526167,6431.0,3233803,,,483.0,265291.0,4952,3791458,6914,3499094,11383,7025198
206,2021-07-08,4837,3531004,6196.0,3239999,,,564.0,265855.0,5401,3796859,6760,3505854,11597,7036795
207,2021-07-09,5367,3536371,6695.0,3246694,,,574.0,266429.0,5941,3802800,7269,3513123,12636,7049431
208,2021-07-10,3528,3539899,4412.0,3251106,,,305.0,266734.0,3833,3806633,4717,3517840,8245,7057676
209,2021-07-11,2683,3542582,2582.0,3253688,,,227.0,266961.0,2910,3809543,2809,3520649,5492,7063168
210,2021-07-12,4429,3547011,5132.0,3258820,,,379.0,267340.0,4808,3814351,5511,3526160,9940,7073108
211,2021-07-13,4672,3551683,4733.0,3263553,,,366.0,267706.0,5038,3819389,5099,3531259,9771,7082879
212,2021-07-14,4634,3556317,5300.0,3268853,,,421.0,268127.0,5055,3824444,5721,3536980,10355,7093234
213,2021-07-15,4912,3561229,5029.0,3273882,,,359.0,268486.0,5271,3829715,5388,3542368,10300,7103534
214,2021-07-16,6284,3567513,5876.0,3279758,,,405.0,268891.0,6689,3836404,6281,3548649,12565,7116099
215,2021-07-17,3422,3570935,3555.0,3283313,,,304.0,269195.0,3726,3840130,3859,3552508,7281,7123380
216,2021-07-18,2312,3573247,2385.0,3285698,,,110.0,269305.0,2422,3842552,2495,3555003,4807,7128187
217,2021-07-19,5152,3578399,4618.0,3290316,,,383.0,269688.0,5535,3848087,5001,3560004,10153,7138340
218,2021-07-20,5349,3583748,4737.0,3295053,,,367.0,270055.0,5716,3853803,5104,3565108,10453,7148793
219,2021-07-21,5667,3589415,4969.0,3300022,,,415.0,270470.0,6082,3859885,5384,3570492,11051,7159844
220,2021-07-22,6034,3595449,4653.0,3304675,,,472.0,270942.0,6506,3866391,5125,3575617,11159,7171003
221,2021-07-23,6849,3602298,4856.0,3309531,,,499.0,271441.0,7348,3873739,5355,3580972,12204,7183207
222,2021-07-24,4286,3606584,3209.0,3312740,,,267.0,271708.0,4553,3878292,3476,3584448,7762,7190969
223,2021-07-25,3302,3609886,1122.0,3313862,,,140.0,271848.0,3442,3881734,1262,3585710,4564,7195533
224,2021-07-26,6223,3616109,3918.0,3317780,,,420.0,272268.0,6643,3888377,4338,3590048,10561,7206094
225,2021-07-27,6616,3622725,4307.0,3322087,,,459.0,272727.0,7075,3895452,4766,3594814,11382,7217476
226,2021-07-28,7095,3629820,4158.0,3326245,,,462.0,273189.0,7557,3903009,4620,3599434,11715,7229191
227,2021-07-29,7093,3636913,4330.0,3330575,,,420.0,273609.0,7513,3910522,4750,3604184,11843,7241034
228,2021-07-30,7837,3644750,4840.0,3335415,,,527.0,274136.0,8364,3918886,5367,3609551,13204,7254238
229,2021-07-31,4792,3649542,3089.0,3338504,,,274.0,274410.0,5066,3923952,3363,3612914,8155,7262393
230,2021-08-01,3918,3653460,2198.0,3340702,180.0,180.0,165.0,274575.0,4083,3928035,2363,3615277,6461,7268854
231,2021-08-02,7283,3660743,3852.0,3344554,130.0,310.0,342.0,274917.0,7625,3935660,4194,3619471,11607,7280461
232,2021-08-03,7281,3668024,4117.0,3348671,92.0,402.0,517.0,275434.0,7798,3943458,4634,3624105,12007,7292468
233,2021-08-04,7442,3675466,4132.0,3352803,100.0,502.0,536.0,275970.0,7978,3951436,4668,3628773,12210,7304678
234,2021-08-05,7962,3683428,4348.0,3357151,97.0,599.0,541.0,276511.0,8503,3959939,4889,3633662,12948,7317626
235,2021-08-06,8335,3691763,4763.0,3361914,124.0,723.0,454.0,276965.0,8789,3968728,5217,3638879,13676,7331302
236,2021-08-07,5305,3697068,2849.0,3364763,90.0,813.0,264.0,277229.0,5569,3974297,3113,3641992,8508,7339810
237,2021-08-08,3982,3701050,2063.0,3366826,66.0,879.0,146.0,277375.0,4128,3978425,2209,3644201,6257,7346067
238,2021-08-09,6963,3708013,4570.0,3371396,100.0,979.0,371.0,277746.0,7334,3985759,4941,3649142,12004,7358071
239,2021-08-10,7176,3715189,4507.0,3375903,112.0,1091.0,340.0,278086.0,7516,3993275,4847,3653989,12135,7370206
240,2021-08-11,7108,3722297,4461.0,3380364,108.0,1199.0,443.0,278529.0,7551,4000826,4904,3658893,12120,7382326
241,2021-08-12,8669,3730966,4775.0,3385139,151.0,1350.0,446.0,278975.0,9115,4009941,5221,3664114,14041,7396367
242,2021-08-13,7190,3738156,5420.0,3390559,200.0,1550.0,397.0,279372.0,7587,4017528,5817,3669931,13207,7409574
243,2021-08-14,4930,3743086,3357.0,3393916,679.0,2229.0,287.0,279659.0,5217,4022745,3644,3673575,9253,7418827
244,2021-08-15,3332,3746418,2750.0,3396666,573.0,2802.0,163.0,279822.0,3495,4026240,2913,3676488,6818,7425645
245,2021-08-16,5462,3751880,5107.0,3401773,1247.0,4049.0,354.0,280176.0,5816,4032056,5461,3681949,12170,7437815
246,2021-08-17,6832,3758712,5381.0,3407154,1447.0,5496.0,391.0,280567.0,7223,4039279,5772,3687721,14051,7451866
247,2021-08-18,6352,3765064,5532.0,3412686,1633.0,7129.0,481.0,281048.0,6833,4046112,6013,3693734,13998,7465864
248,2021-08-19,6241,3771305,5587.0,3418273,1632.0,8761.0,417.0,281465.0,6658,4052770,6004,3699738,13877,7479741
249,2021-08-20,6858,3778163,6578.0,3424851,1733.0,10494.0,401.0,281866.0,7259,4060029,6979,3706717,15570,7495311
250,2021-08-21,4349,3782512,3929.0,3428780,877.0,11371.0,229.0,282095.0,4578,4064607,4158,3710875,9384,7504695
251,2021-08-22,3066,3785578,3179.0,3431959,807.0,12178.0,111.0,282206.0,3177,4067784,3290,3714165,7163,7511858
252,2021-08-23,6005,3791583,6141.0,3438100,1804.0,13982.0,287.0,282493.0,6292,4074076,6428,3720593,14237,7526095
253,2021-08-24,6558,3798141,6104.0,3444204,1733.0,15715.0,426.0,282919.0,6984,4081060,6530,3727123,14821,7540916
254,2021-08-25,6738,3804879,6254.0,3450458,1599.0,17314.0,440.0,283359.0,7178,4088238,6694,3733817,15031,7555947
255,2021-08-26,6973,3811852,6688.0,3457146,1727.0,19041.0,428.0,283787.0,7401,4095639,7116,3740933,15816,7571763
256,2021-08-27,6850,3818702,7110.0,3464256,2006.0,21047.0,317.0,284104.0,7167,4102806,7427,3748360,16283,7588046
257,2021-08-28,6919,3825621,6544.0,3470800,1005.0,22052.0,329.0,284433.0,7248,4110054,6873,3755233,14797,7602843
258,2021-08-29,3747,3829368,3710.0,3474510,681.0,22733.0,610.0,285043.0,4357,4114411,4320,3759553,8748,7611591
259,2021-08-30,5934,3835302,6158.0,3480668,1540.0,24273.0,960.0,286003.0,6894,4121305,7118,3766671,14592,7626183
260,2021-08-31,5910,3841212,6096.0,3486764,1659.0,25932.0,947.0,286950.0,6857,4128162,7043,3773714,14612,7640795
261,2021-09-01,5618,3846830,5743.0,3492507,1771.0,27703.0,918.0,287868.0,6536,4134698,6661,3780375,14050,7654845
262,2021-09-02,5531,3852361,5978.0,3498485,1860.0,29563.0,709.0,288577.0,6240,4140938,6687,3787062,14078,7668923
263,2021-09-03,6024,3858385,6985.0,3505470,1844.0,31407.0,977.0,289554.0,7001,4147939,7962,3795024,15830,7684753
264,2021-09-04,3734,3862119,4370.0,3509840,876.0,32283.0,878.0,290432.0,4612,4152551,5248,3800272,9858,7694611
265,2021-09-05,2961,3865080,2819.0,3512659,655.0,32938.0,106.0,290538.0,3067,4155618,2925,3803197,6541,7701152
266,2021-09-06,1060,3866140,1163.0,3513822,217.0,33155.0,70.0,290608.0,1130,4156748,1233,3804430,2510,7703662
267,2021-09-07,5353,3871493,7325.0,3521147,1422.0,34577.0,2304.0,292912.0,7657,4164405,9629,3814059,16404,7720066
268,2021-09-08,4663,3876156,5507.0,3526654,1567.0,36144.0,364.0,293276.0,5027,4169432,5871,3819930,12101,7732167
269,2021-09-09,5027,3881183,5481.0,3532135,2289.0,38433.0,325.0,293601.0,5352,4174784,5806,3825736,13122,7745289
270,2021-09-10,6535,3887718,6683.0,3538818,2475.0,40908.0,1719.0,295320.0,8254,4183038,8402,3834138,17412,7762701
271,2021-09-11,4182,3891900,4354.0,3543172,1015.0,41923.0,666.0,295986.0,4848,4187886,5020,3839158,10217,7772918
272,2021-09-12,3175,3895075,3247.0,3546419,699.0,42622.0,436.0,296422.0,3611,4191497,3683,3842841,7557,7780475
273,2021-09-13,4896,3899971,5086.0,3551505,1537.0,44159.0,347.0,296769.0,5243,4196740,5433,3848274,11866,7792341
274,2021-09-14,4778,3904749,5468.0,3556973,1599.0,45758.0,437.0,297206.0,5215,4201955,5905,3854179,12282,7804623
275,2021-09-15,5046,3909795,5905.0,3562878,1485.0,47243.0,393.0,297599.0,5439,4207394,6298,3860477,12829,7817452
276,2021-09-16,4817,3914612,5861.0,3568739,1607.0,48850.0,337.0,297936.0,5154,4212548,6198,3866675,12622,7830074
277,2021-09-17,5293,3919905,6601.0,3575340,1931.0,50781.0,344.0,298280.0,5637,4218185,6945,3873620,14169,7844243
278,2021-09-18,3825,3923730,4591.0,3579931,932.0,51713.0,186.0,298466.0,4011,4222196,4777,3878397,9534,7853777
279,2021-09-19,2742,3926472,3184.0,3583115,694.0,52407.0,75.0,298541.0,2817,4225013,3259,3881656,6695,7860472
280,2021-09-20,3755,3930227,4691.0,3587806,1745.0,54152.0,429.0,298970.0,4184,4229197,5120,3886776,10620,7871092
281,2021-09-21,4004,3934231,5024.0,3592830,1853.0,56005.0,327.0,299297.0,4331,4233528,5351,3892127,11208,7882300
282,2021-09-22,4194,3938425,4803.0,3597633,1742.0,57747.0,459.0,299756.0,4653,4238181,5262,3897389,11198,7893498
283,2021-09-23,4192,3942617,4739.0,3602372,2179.0,59926.0,492.0,300248.0,4684,4242865,5231,3902620,11602,7905100
284,2021-09-24,5098,3947715,5638.0,3608010,4830.0,64756.0,422.0,300670.0,5520,4248385,6060,3908680,15988,7921088
285,2021-09-25,3644,3951359,3642.0,3611652,4925.0,69681.0,384.0,301054.0,4028,4252413,4026,3912706,12595,7933683
286,2021-09-26,2353,3953712,2672.0,3614324,3077.0,72758.0,433.0,301487.0,2786,4255199,3105,3915811,8535,7942218
287,2021-09-27,4510,3958222,2720.0,3617044,8874.0,81632.0,512.0,301999.0,5022,4260221,3232,3919043,16616,7958834
288,2021-09-28,4414,3962636,4466.0,3621510,9492.0,91124.0,211.0,302210.0,4625,4264846,4677,3923720,18583,7977417
289,2021-09-29,4695,3967331,4537.0,3626047,9867.0,100991.0,920.0,303130.0,5615,4270461,5457,3929177,20019,7997436
290,2021-09-30,4895,3972226,4581.0,3630628,9976.0,110967.0,796.0,303926.0,5691,4276152,5377,3934554,20248,8017684
291,2021-10-01,5531,3977757,5378.0,3636006,11999.0,122966.0,785.0,304711.0,6316,4282468,6163,3940717,23693,8041377
292,2021-10-02,2949,3980706,2907.0,3638913,5778.0,128744.0,187.0,304898.0,3136,4285604,3094,3943811,11821,8053198
293,2021-10-03,2078,3982784,2384.0,3641297,3464.0,132208.0,87.0,304985.0,2165,4287769,2471,3946282,8013,8061211
294,2021-10-04,4032,3986816,3511.0,3644808,9856.0,142064.0,233.0,305218.0,4265,4292034,3744,3950026,17632,8078843
295,2021-10-05,3963,3990779,3675.0,3648483,10199.0,152263.0,206.0,305424.0,4169,4296203,3881,3953907,18043,8096886
296,2021-10-06,4035,3994814,3580.0,3652063,8976.0,161239.0,266.0,305690.0,4301,4300504,3846,3957753,16857,8113743
297,2021-10-07,4233,3999047,3642.0,3655705,10015.0,171254.0,332.0,306022.0,4565,4305069,3974,3961727,18222,8131965
298,2021-10-08,4783,4003830,4308.0,3660013,11448.0,182702.0,283.0,306305.0,5066,4310135,4591,3966318,20822,8152787
299,2021-10-09,2693,4006523,2683.0,3662696,4314.0,187016.0,270.0,306575.0,2963,4313098,2953,3969271,9960,8162747
300,2021-10-10,1860,4008383,1855.0,3664551,3589.0,190605.0,59.0,306634.0,1919,4315017,1914,3971185,7363,8170110
301,2021-10-11,4213,4012596,3319.0,3667870,9273.0,199878.0,250.0,306884.0,4463,4319480,3569,3974754,17055,8187165
302,2021-10-12,3605,4016201,3549.0,3671419,9740.0,209618.0,276.0,307160.0,3881,4323361,3825,3978579,17170,8204335
303,2021-10-13,3992,4020193,3475.0,3674894,8957.0,218575.0,346.0,307506.0,4338,4327699,3821,3982400,16770,8221105
304,2021-10-14,5175,4025368,5508.0,3680402,9551.0,228126.0,430.0,307936.0,5605,4333304,5938,3988338,20664,8241769
305,2021-10-15,4770,4030138,4621.0,3685023,10666.0,238792.0,347.0,308283.0,5117,4338421,4968,3993306,20404,8262173
306,2021-10-16,2497,4032635,2531.0,3687554,4691.0,243483.0,291.0,308574.0,2788,4341209,2822,3996128,10010,8272183
307,2021-10-17,1809,4034444,1782.0,3689336,2788.0,246271.0,55.0,308629.0,1864,4343073,1837,3997965,6434,8278617
308,2021-10-18,4281,4038725,3588.0,3692924,9262.0,255533.0,283.0,308912.0,4564,4347637,3871,4001836,17414,8296031
309,2021-10-19,4307,4043032,4033.0,3696957,9641.0,265174.0,224.0,309136.0,4531,4352168,4257,4006093,18205,8314236
310,2021-10-20,3546,4046578,3435.0,3700392,9090.0,274264.0,259.0,309395.0,3805,4355973,3694,4009787,16330,8330566
311,2021-10-21,3312,4049890,3288.0,3703680,10020.0,284284.0,291.0,309686.0,3603,4359576,3579,4013366,16911,8347477
312,2021-10-22,4691,4054581,4043.0,3707723,18899.0,303183.0,477.0,310163.0,5168,4364744,4520,4017886,28110,8375587
313,2021-10-23,2887,4057468,2119.0,3709842,11118.0,314301.0,322.0,310485.0,3209,4367953,2441,4020327,16446,8392033
314,2021-10-24,2058,4059526,1555.0,3711397,7209.0,321510.0,79.0,310564.0,2137,4370090,1634,4021961,10901,8402934
315,2021-10-25,4556,4064082,3084.0,3714481,23323.0,344833.0,322.0,310886.0,4878,4374968,3406,4025367,31285,8434219
316,2021-10-26,4534,4068616,3089.0,3717570,25667.0,370500.0,316.0,311202.0,4850,4379818,3405,4028772,33606,8467825
317,2021-10-27,4736,4073352,3353.0,3720923,25685.0,396185.0,436.0,311638.0,5172,4384990,3789,4032561,34210,8502035
318,2021-10-28,4577,4077929,3373.0,3724296,26647.0,422832.0,501.0,312139.0,5078,4390068,3874,4036435,35098,8537133
319,2021-10-29,4998,4082927,3931.0,3728227,26523.0,449355.0,395.0,312534.0,5393,4395461,4326,4040761,35847,8572980
320,2021-10-30,2631,4085558,1848.0,3730075,13746.0,463101.0,307.0,312841.0,2938,4398399,2155,4042916,18532,8591512
321,2021-10-31,1935,4087493,1522.0,3731597,7837.0,470938.0,94.0,312935.0,2029,4400428,1616,4044532,11388,8602900
322,2021-11-01,4751,4092244,3457.0,3735054,25971.0,496909.0,351.0,313286.0,5102,4405530,3808,4048340,34530,8637430
323,2021-11-02,4281,4096525,2950.0,3738004,26174.0,523083.0,409.0,313695.0,4690,4410220,3359,4051699,33814,8671244
324,2021-11-03,4682,4101207,3053.0,3741057,26204.0,549287.0,464.0,314159.0,5146,4415366,3517,4055216,34403,8705647
325,2021-11-04,6331,4107538,3384.0,3744441,27339.0,576626.0,529.0,314688.0,6860,4422226,3913,4059129,37583,8743230
326,2021-11-05,8264,4115802,3786.0,3748227,28299.0,604925.0,415.0,315103.0,8679,4430905,4201,4063330,40764,8783994
327,2021-11-06,10203,4126005,1977.0,3750204,13052.0,617977.0,309.0,315412.0,10512,4441417,2286,4065616,25541,8809535
328,2021-11-07,7750,4133755,1463.0,3751667,7403.0,625380.0,95.0,315507.0,7845,4449262,1558,4067174,16711,8826246
329,2021-11-08,11359,4145114,3066.0,3754733,19743.0,645123.0,379.0,315886.0,11738,4461000,3445,4070619,34547,8860793
330,2021-11-09,11808,4156922,2654.0,3757387,23245.0,668368.0,269.0,316155.0,12077,4473077,2923,4073542,37976,8898769
331,2021-11-10,12635,4169557,2775.0,3760162,23860.0,692228.0,339.0,316494.0,12974,4486051,3114,4076656,39609,8938378
332,2021-11-11,11448,4181005,2385.0,3762547,22214.0,714442.0,280.0,316774.0,11728,4497779,2665,4079321,36327,8974705
333,2021-11-12,12386,4193391,3378.0,3765925,26369.0,740811.0,548.0,317322.0,12934,4510713,3926,4083247,42681,9017386
334,2021-11-13,9982,4203373,1602.0,3767527,12436.0,753247.0,342.0,317664.0,10324,4521037,1944,4085191,24362,9041748
335,2021-11-14,4246,4207619,1119.0,3768646,7336.0,760583.0,121.0,317785.0,4367,4525404,1240,4086431,12822,9054570
336,2021-11-15,8656,4216275,2524.0,3771170,21029.0,781612.0,211.0,317996.0,8867,4534271,2735,4089166,32420,9086990
337,2021-11-16,9296,4225571,2513.0,3773683,23324.0,804936.0,258.0,318254.0,9554,4543825,2771,4091937,35391,9122381
338,2021-11-17,9421,4234992,2867.0,3776550,22894.0,827830.0,313.0,318567.0,9734,4553559,3180,4095117,35495,9157876
339,2021-11-18,9330,4244322,2630.0,3779180,22959.0,850789.0,481.0,319048.0,9811,4563370,3111,4098228,35400,9193276
340,2021-11-19,9849,4254171,2927.0,3782107,27973.0,878762.0,381.0,319429.0,10230,4573600,3308,4101536,41130,9234406
341,2021-11-20,10666,4264837,1608.0,3783715,14610.0,893372.0,455.0,319884.0,11121,4584721,2063,4103599,27339,9261745
342,2021-11-21,4397,4269234,1208.0,3784923,9994.0,903366.0,100.0,319984.0,4497,4589218,1308,4104907,15699,9277444
343,2021-11-22,9857,4279091,2513.0,3787436,25082.0,928448.0,293.0,320277.0,10150,4599368,2806,4107713,37745,9315189
344,2021-11-23,9255,4288346,2410.0,3789846,25307.0,953755.0,317.0,320594.0,9572,4608940,2727,4110440,37289,9352478
345,2021-11-24,8192,4296538,2444.0,3792290,20473.0,974228.0,216.0,320810.0,8408,4617348,2660,4113100,31325,9383803
346,2021-11-25,235,4296773,81.0,3792371,614.0,974842.0,10.0,320820.0,245,4617593,91,4113191,940,9384743
347,2021-11-26,5671,4302444,3982.0,3796353,16095.0,990937.0,153.0,320973.0,5824,4623417,4135,4117326,25901,9410644
348,2021-11-27,3785,4306229,5497.0,3801850,11313.0,1002250.0,134.0,321107.0,3919,4627336,5631,4122957,20729,9431373
349,2021-11-28,2408,4308637,6409.0,3808259,7743.0,1009993.0,77.0,321184.0,2485,4629821,6486,4129443,16637,9448010
350,2021-11-29,6396,4315033,9334.0,3817593,19259.0,1029252.0,380.0,321564.0,6776,4636597,9714,4139157,35369,9483379
351,2021-11-30,6277,4321310,9377.0,3826970,23319.0,1052571.0,264.0,321828.0,6541,4643138,9641,4148798,39237,9522616
352,2021-12-01,7351,4328661,9770.0,3836740,26115.0,1078686.0,309.0,322137.0,7660,4650798,10079,4158877,43545,9566161
353,2021-12-02,6962,4335623,8865.0,3845605,27637.0,1106323.0,450.0,322587.0,7412,4658210,9315,4168192,43914,9610075
354,2021-12-03,7644,4343267,9377.0,3854982,31189.0,1137512.0,253.0,322840.0,7897,4666107,9630,4177822,48463,9658538
355,2021-12-04,5965,4349232,10148.0,3865130,17278.0,1154790.0,468.0,323308.0,6433,4672540,10616,4188438,33859,9692397
356,2021-12-05,3450,4352682,3588.0,3868718,9977.0,1164767.0,78.0,323386.0,3528,4676068,3666,4192104,17093,9709490
357,2021-12-06,6783,4359465,7119.0,3875837,25058.0,1189825.0,281.0,323667.0,7064,4683132,7400,4199504,39241,9748731
358,2021-12-07,6459,4365924,7090.0,3882927,26009.0,1215834.0,252.0,323919.0,6711,4689843,7342,4206846,39810,9788541
359,2021-12-08,6953,4372877,7451.0,3890378,25164.0,1240998.0,316.0,324235.0,7269,4697112,7767,4214613,39884,9828425
360,2021-12-09,6553,4379430,7080.0,3897458,25963.0,1266961.0,399.0,324634.0,6952,4704064,7479,4222092,39995,9868420
361,2021-12-10,7310,4386740,7369.0,3904827,27532.0,1294493.0,233.0,324867.0,7543,4711607,7602,4229694,42444,9910864
362,2021-12-11,4468,4391208,7715.0,3912542,14891.0,1309384.0,333.0,325200.0,4801,4716408,8048,4237742,27407,9938271
363,2021-12-12,4011,4395219,2815.0,3915357,8165.0,1317549.0,60.0,325260.0,4071,4720479,2875,4240617,15051,9953322
364,2021-12-13,5788,4401007,5836.0,3921193,22794.0,1340343.0,243.0,325503.0,6031,4726510,6079,4246696,34661,9987983
365,2021-12-14,6476,4407483,5967.0,3927160,24196.0,1364539.0,223.0,325726.0,6699,4733209,6190,4252886,36862,10024845
366,2021-12-15,7197,4414680,5741.0,3932901,22613.0,1387152.0,259.0,325985.0,7456,4740665,6000,4258886,35810,10060655
367,2021-12-16,7917,4422597,2841.0,3935742,25989.0,1413141.0,423.0,326408.0,8340,4749005,3264,4262150,37170,10097825
368,2021-12-17,7883,4430480,4196.0,3939938,27242.0,1440383.0,195.0,326603.0,8078,4757083,4391,4266541,39516,10137341
369,2021-12-18,5858,4436338,3204.0,3943142,15967.0,1456350.0,298.0,326901.0,6156,4763239,3502,4270043,25327,10162668
370,2021-12-19,3391,4439729,1354.0,3944496,9854.0,1466204.0,37.0,326938.0,3428,4766667,1391,4271434,14636,10177304
371,2021-12-20,8128,4447857,3775.0,3948271,27283.0,1493487.0,174.0,327112.0,8302,4774969,3949,4275383,39360,10216664
372,2021-12-21,9089,4456946,4228.0,3952499,27902.0,1521389.0,177.0,327289.0,9266,4784235,4405,4279788,41396,10258060
373,2021-12-22,8739,4465685,3917.0,3956416,27878.0,1549267.0,184.0,327473.0,8923,4793158,4101,4283889,40718,10298778
374,2021-12-23,8458,4474143,3599.0,3960015,23570.0,1572837.0,359.0,327832.0,8817,4801975,3958,4287847,35986,10334764
375,2021-12-24,1638,4475781,1017.0,3961032,4761.0,1577598.0,39.0,327871.0,1677,4803652,1056,4288903,7455,10342219
376,2021-12-25,47,4475828,36.0,3961068,283.0,1577881.0,1.0,327872.0,48,4803700,37,4288940,367,10342586
377,2021-12-26,2520,4478348,1757.0,3962825,7109.0,1584990.0,44.0,327916.0,2564,4806264,1801,4290741,11430,10354016
378,2021-12-27,7272,4485620,4051.0,3966876,21253.0,1606243.0,297.0,328213.0,7569,4813833,4348,4295089,32873,10386889
379,2021-12-28,7974,4493594,3887.0,3970763,24091.0,1630334.0,179.0,328392.0,8153,4821986,4066,4299155,36131,10423020
380,2021-12-29,8271,4501865,4040.0,3974803,22791.0,1653125.0,156.0,328548.0,8427,4830413,4196,4303351,35258,10458278
381,2021-12-30,7511,4509376,3813.0,3978616,21402.0,1674527.0,291.0,328839.0,7802,4838215,4104,4307455,33017,10491295
382,2021-12-31,2585,4511961,1542.0,3980158,7279.0,1681806.0,90.0,328929.0,2675,4840890,1632,4309087,11496,10502791
383,2022-01-01,741,4512702,353.0,3980511,1807.0,1683613.0,34.0,328963.0,775,4841665,387,4309474,2935,10505726
384,2022-01-02,2220,4514922,1655.0,3982166,5502.0,1689115.0,48.0,329011.0,2268,4843933,1703,4311177,9425,10515151
385,2022-01-03,3393,4518315,2090.0,3984256,10699.0,1699814.0,224.0,329235.0,3617,4847550,2314,4313491,16406,10531557
386,2022-01-04,5878,4524193,3537.0,3987793,15905.0,1715719.0,165.0,329400.0,6043,4853593,3702,4317193,25485,10557042
387,2022-01-05,6852,4531045,4720.0,3992513,17965.0,1733684.0,176.0,329576.0,7028,4860621,4896,4322089,29713,10586755
388,2022-01-06,6837,4537882,4883.0,3997396,22148.0,1755832.0,265.0,329841.0,7102,4867723,5148,4327237,34133,10620888
389,2022-01-07,6050,4543932,3861.0,4001257,19364.0,1775196.0,162.0,330003.0,6212,4873935,4023,4331260,29437,10650325
390,2022-01-08,4826,4548758,3931.0,4005188,13194.0,1788390.0,78.0,330081.0,4904,4878839,4009,4335269,22029,10672354
391,2022-01-09,2767,4551525,2030.0,4007218,7526.0,1795916.0,154.0,330235.0,2921,4881760,2184,4337453,12477,10684831
392,2022-01-10,6362,4557887,3878.0,4011096,18601.0,1814517.0,161.0,330396.0,6523,4888283,4039,4341492,29002,10713833
393,2022-01-11,6557,4564444,4306.0,4015402,17900.0,1832417.0,143.0,330539.0,6700,4894983,4449,4345941,28906,10742739
394,2022-01-12,6842,4571286,4468.0,4019870,18393.0,1850810.0,225.0,330764.0,7067,4902050,4693,4350634,29928,10772667
395,2022-01-13,6706,4577992,4412.0,4024282,17192.0,1868002.0,153.0,330917.0,6859,4908909,4565,4355199,28463,10801130
396,2022-01-14,7268,4585260,3316.0,4027598,21832.0,1889834.0,253.0,331170.0,7521,4916430,3569,4358768,32669,10833799
397,2022-01-15,4299,4589559,1702.0,4029300,11510.0,1901344.0,71.0,331241.0,4370,4920800,1773,4360541,17582,10851381
398,2022-01-16,2224,4591783,1324.0,4030624,6181.0,1907525.0,116.0,331357.0,2340,4923140,1440,4361981,9845,10861226
399,2022-01-17,3632,4595415,2390.0,4033014,10090.0,1917615.0,75.0,331432.0,3707,4926847,2465,4364446,16187,10877413
400,2022-01-18,5304,4600719,4235.0,4037249,13159.0,1930774.0,103.0,331535.0,5407,4932254,4338,4368784,22801,10900214
401,2022-01-19,5298,4606017,4508.0,4041757,13133.0,1943907.0,99.0,331634.0,5397,4937651,4607,4373391,23038,10923252
402,2022-01-20,4544,4610561,3643.0,4045400,11706.0,1955613.0,176.0,331810.0,4720,4942371,3819,4377210,20069,10943321
403,2022-01-21,5616,4616177,2955.0,4048355,14862.0,1970475.0,126.0,331936.0,5742,4948113,3081,4380291,23559,10966880
404,2022-01-22,3481,4619658,1730.0,4050085,8927.0,1979402.0,134.0,332070.0,3615,4951728,1864,4382155,14272,10981152
405,2022-01-23,2052,4621710,1504.0,4051589,5746.0,1985148.0,30.0,332100.0,2082,4953810,1534,4383689,9332,10990484
406,2022-01-24,4134,4625844,2784.0,4054373,11317.0,1996465.0,90.0,332190.0,4224,4958034,2874,4386563,18325,11008809
407,2022-01-25,3847,4629691,3335.0,4057708,9214.0,2005679.0,95.0,332285.0,3942,4961976,3430,4389993,16491,11025300
408,2022-01-26,3886,4633577,3718.0,4061426,9075.0,2014754.0,95.0,332380.0,3981,4965957,3813,4393806,16774,11042074
409,2022-01-27,3770,4637347,3959.0,4065385,10249.0,2025003.0,188.0,332568.0,3958,4969915,4147,4397953,18166,11060240
410,2022-01-28,3864,4641211,3298.0,4068683,11277.0,2036280.0,76.0,332644.0,3940,4973855,3374,4401327,18515,11078755
411,2022-01-29,2313,4643524,2301.0,4070984,5877.0,2042157.0,117.0,332761.0,2430,4976285,2418,4403745,10608,11089363
412,2022-01-30,1565,4645089,1647.0,4072631,3764.0,2045921.0,16.0,332777.0,1581,4977866,1663,4405408,6992,11096355
413,2022-01-31,3013,4648102,3248.0,4075879,7640.0,2053561.0,58.0,332835.0,3071,4980937,3306,4408714,13959,11110314
414,2022-02-01,2656,4650758,3414.0,4079293,6768.0,2060329.0,75.0,332910.0,2731,4983668,3489,4412203,12913,11123227
415,2022-02-02,2832,4653590,3734.0,4083027,6596.0,2066925.0,78.0,332988.0,2910,4986578,3812,4416015,13240,11136467
416,2022-02-03,2767,4656357,3671.0,4086698,6888.0,2073813.0,42.0,333030.0,2809,4989387,3713,4419728,13368,11149835
417,2022-02-04,2785,4659142,4402.0,4091100,7753.0,2081566.0,128.0,333158.0,2913,4992300,4530,4424258,15068,11164903
418,2022-02-05,1924,4661066,2913.0,4094013,5027.0,2086593.0,112.0,333270.0,2036,4994336,3025,4427283,9976,11174879
419,2022-02-06,1079,4662145,1357.0,4095370,2478.0,2089071.0,24.0,333294.0,1103,4995439,1381,4428664,4938,11179817
420,2022-02-07,2063,4664208,2713.0,4098083,5237.0,2094308.0,51.0,333345.0,2114,4997553,2764,4431428,10064,11189881
421,2022-02-08,2094,4666302,3107.0,4101190,5227.0,2099535.0,63.0,333408.0,2157,4999710,3170,4434598,10491,11200372
422,2022-02-09,2212,4668514,3324.0,4104514,5863.0,2105398.0,76.0,333484.0,2288,5001998,3400,4437998,11475,11211847
423,2022-02-10,2095,4670609,2883.0,4107397,5840.0,2111238.0,55.0,333539.0,2150,5004148,2938,4440936,10873,11222720
424,2022-02-11,2523,4673132,3533.0,4110930,7615.0,2118853.0,123.0,333662.0,2646,5006794,3656,4444592,13794,11236514
425,2022-02-12,1684,4674816,2322.0,4113252,4551.0,2123404.0,97.0,333759.0,1781,5008575,2419,4447011,8654,11245168
426,2022-02-13,739,4675555,1086.0,4114338,1828.0,2125232.0,17.0,333776.0,756,5009331,1103,4448114,3670,11248838
427,2022-02-14,1467,4677022,2248.0,4116586,4044.0,2129276.0,65.0,333841.0,1532,5010863,2313,4450427,7824,11256662
428,2022-02-15,1949,4678971,2473.0,4119059,4027.0,2133303.0,47.0,333888.0,1996,5012859,2520,4452947,8496,11265158
429,2022-02-16,1693,4680664,2454.0,4121513,4003.0,2137306.0,52.0,333940.0,1745,5014604,2506,4455453,8202,11273360
430,2022-02-17,16885,4697549,13044.0,4134557,3826.0,2141132.0,485.0,334425.0,17370,5031974,13529,4468982,34240,11307600
431,2022-02-18,2013,4699562,2611.0,4137168,4811.0,2145943.0,49.0,334474.0,2062,5034036,2660,4471642,9484,11317084
432,2022-02-19,1240,4700802,1708.0,4138876,3017.0,2148960.0,39.0,334513.0,1279,5035315,1747,4473389,6004,11323088
433,2022-02-20,711,4701513,851.0,4139727,1742.0,2150702.0,15.0,334528.0,726,5036041,866,4474255,3319,11326407
434,2022-02-21,1309,4702822,1791.0,4141518,3030.0,2153732.0,32.0,334560.0,1341,5037382,1823,4476078,6162,11332569
435,2022-02-22,1459,4704281,1903.0,4143421,3109.0,2156841.0,36.0,334596.0,1495,5038877,1939,4478017,6507,11339076
436,2022-02-23,1574,4705855,1880.0,4145301,3208.0,2160049.0,35.0,334631.0,1609,5040486,1915,4479932,6697,11345773
437,2022-02-24,1451,4707306,1622.0,4146923,2806.0,2162855.0,38.0,334669.0,1489,5041975,1660,4481592,5917,11351690
438,2022-02-25,1552,4708858,1732.0,4148655,3781.0,2166636.0,68.0,334737.0,1620,5043595,1800,4483392,7133,11358823
439,2022-02-26,1097,4709955,1126.0,4149781,2414.0,2169050.0,42.0,334779.0,1139,5044734,1168,4484560,4679,11363502
440,2022-02-27,194,4710149,158.0,4149939,476.0,2169526.0,5.0,334784.0,199,5044933,163,4484723,833,11364335
