,VACCINATION_DATE,FirstDailyDose,FirstDoseCumulative,SecondDailyDose,SecondDoseCumulative,AdditionalDailyDose,AdditionalDoseCumulative,SingleDailyDose,SingleDoseCumulative,AtleastOneVaccine,AtleastOneVaccineCumulative,CompletedVax,CompletedVaxCumulative,FirstSecondSingleVaccinations,FirstSecondSingleVaccinationsCumulative
0,2020-12-14,19,1320,,514,,,,,19,1320,0,514,19,1730
1,2020-12-15,59,1379,3.0,517,,,,,59,1379,3,517,62,1792
2,2020-12-16,587,1966,5.0,522,,,,,587,1966,5,522,592,2384
3,2020-12-17,1154,3120,5.0,527,,,,,1154,3120,5,527,1159,3543
4,2020-12-18,3010,6130,13.0,540,,,,,3010,6130,13,540,3023,6566
5,2020-12-19,928,7058,5.0,545,,,,,928,7058,5,545,933,7499
6,2020-12-20,358,7416,5.0,550,,,,,358,7416,5,550,363,7862
7,2020-12-21,3883,11299,26.0,576,,,,,3883,11299,26,576,3909,11771
8,2020-12-22,6318,17617,25.0,601,,,,,6318,17617,25,601,6343,18114
9,2020-12-23,5772,23389,35.0,636,,,,,5772,23389,35,636,5807,23921
10,2020-12-24,2722,26111,16.0,652,,,,,2722,26111,16,652,2738,26659
11,2020-12-25,1034,27145,4.0,656,,,,,1034,27145,4,656,1038,27697
12,2020-12-26,1881,29026,9.0,665,,,,,1881,29026,9,665,1890,29587
13,2020-12-27,1803,30829,10.0,675,,,,,1803,30829,10,675,1813,31400
14,2020-12-28,8979,39808,47.0,722,,,,,8979,39808,47,722,9026,40426
15,2020-12-29,10956,50764,50.0,772,,,,,10956,50764,50,772,11006,51432
16,2020-12-30,12484,63248,87.0,859,,,,,12484,63248,87,859,12571,64003
17,2020-12-31,7547,70795,45.0,904,,,,,7547,70795,45,904,7592,71595
18,2021-01-01,3166,73961,136.0,1040,,,,,3166,73961,136,1040,3302,74897
19,2021-01-02,3034,76995,34.0,1074,,,,,3034,76995,34,1074,3068,77965
20,2021-01-03,3402,80397,81.0,1155,,,,,3402,80397,81,1155,3483,81448
21,2021-01-04,13348,93745,331.0,1486,,,,,13348,93745,331,1486,13679,95127
22,2021-01-05,12460,106205,542.0,2028,,,,,12460,106205,542,2028,13002,108129
23,2021-01-06,15238,121443,858.0,2886,,,,,15238,121443,858,2886,16096,124225
24,2021-01-07,15010,136453,1760.0,4646,,,,,15010,136453,1760,4646,16770,140995
25,2021-01-08,24000,160453,2772.0,7418,,,,,24000,160453,2772,7418,26772,167767
26,2021-01-09,5160,165613,951.0,8369,,,,,5160,165613,951,8369,6111,173878
27,2021-01-10,2964,168577,380.0,8749,,,,,2964,168577,380,8749,3344,177222
28,2021-01-11,13708,182285,3465.0,12214,,,,,13708,182285,3465,12214,17173,194395
29,2021-01-12,17372,199657,5585.0,17799,,,,,17372,199657,5585,17799,22957,217352
30,2021-01-13,18598,218255,3909.0,21708,,,,,18598,218255,3909,21708,22507,239859
31,2021-01-14,17830,236085,1957.0,23665,,,,,17830,236085,1957,23665,19787,259646
32,2021-01-15,19452,255537,2023.0,25688,,,,,19452,255537,2023,25688,21475,281121
33,2021-01-16,5816,261353,1612.0,27300,,,,,5816,261353,1612,27300,7428,288549
34,2021-01-17,2115,263468,1478.0,28778,,,,,2115,263468,1478,28778,3593,292142
35,2021-01-18,7069,270537,3253.0,32031,,,,,7069,270537,3253,32031,10322,302464
36,2021-01-19,16933,287470,5397.0,37428,,,,,16933,287470,5397,37428,22330,324794
37,2021-01-20,20995,308465,5313.0,42741,,,,,20995,308465,5313,42741,26308,351102
38,2021-01-21,23781,332246,3828.0,46569,,,,,23781,332246,3828,46569,27609,378711
39,2021-01-22,28651,360897,3737.0,50306,,,,,28651,360897,3737,50306,32388,411099
40,2021-01-23,10109,371006,1934.0,52240,,,,,10109,371006,1934,52240,12043,423142
41,2021-01-24,3350,374356,1722.0,53962,,,,,3350,374356,1722,53962,5072,428214
42,2021-01-25,16297,390653,8591.0,62553,,,,,16297,390653,8591,62553,24888,453102
43,2021-01-26,17547,408200,8962.0,71515,,,,,17547,408200,8962,71515,26509,479611
44,2021-01-27,24431,432631,12539.0,84054,,,,,24431,432631,12539,84054,36970,516581
45,2021-01-28,22646,455277,9319.0,93373,,,,,22646,455277,9319,93373,31965,548546
46,2021-01-29,24766,480043,7913.0,101286,,,,,24766,480043,7913,101286,32679,581225
47,2021-01-30,17771,497814,2548.0,103834,,,,,17771,497814,2548,103834,20319,601544
48,2021-01-31,3758,501572,1357.0,105191,,,,,3758,501572,1357,105191,5115,606659
49,2021-02-01,8027,509599,5325.0,110516,,,,,8027,509599,5325,110516,13352,620011
50,2021-02-02,12476,522075,13816.0,124332,,,,,12476,522075,13816,124332,26292,646303
51,2021-02-03,18237,540312,18115.0,142447,,,,,18237,540312,18115,142447,36352,682655
52,2021-02-04,22104,562416,15763.0,158210,,,,,22104,562416,15763,158210,37867,720522
53,2021-02-05,20337,582753,17399.0,175609,,,,,20337,582753,17399,175609,37736,758258
54,2021-02-06,11316,594069,14462.0,190071,,,,,11316,594069,14462,190071,25778,784036
55,2021-02-07,5945,600014,1829.0,191900,,,,,5945,600014,1829,191900,7774,791810
56,2021-02-08,12968,612982,12909.0,204809,,,,,12968,612982,12909,204809,25877,817687
57,2021-02-09,16638,629620,13861.0,218670,,,,,16638,629620,13861,218670,30499,848186
58,2021-02-10,19275,648895,21223.0,239893,,,,,19275,648895,21223,239893,40498,888684
59,2021-02-11,22838,671733,17325.0,257218,,,,,22838,671733,17325,257218,40163,928847
60,2021-02-12,20382,692115,19605.0,276823,,,,,20382,692115,19605,276823,39987,968834
61,2021-02-13,11436,703551,6407.0,283230,,,,,11436,703551,6407,283230,17843,986677
62,2021-02-14,7106,710657,2117.0,285347,,,,,7106,710657,2117,285347,9223,995900
63,2021-02-15,11757,722414,13315.0,298662,,,,,11757,722414,13315,298662,25072,1020972
64,2021-02-16,16596,739010,21001.0,319663,,,,,16596,739010,21001,319663,37597,1058569
65,2021-02-17,20648,759658,26362.0,346025,,,,,20648,759658,26362,346025,47010,1105579
66,2021-02-18,3194,762852,4615.0,350640,,,,,3194,762852,4615,350640,7809,1113388
67,2021-02-19,10254,773106,19920.0,370560,,,,,10254,773106,19920,370560,30174,1143562
68,2021-02-20,10305,783411,20276.0,390836,,,,,10305,783411,20276,390836,30581,1174143
69,2021-02-21,6168,789579,7636.0,398472,,,,,6168,789579,7636,398472,13804,1187947
70,2021-02-22,8029,797608,15462.0,413934,,,,,8029,797608,15462,413934,23491,1211438
71,2021-02-23,15516,813124,15970.0,429904,,,,,15516,813124,15970,429904,31486,1242924
72,2021-02-24,17938,831062,24738.0,454642,,,,,17938,831062,24738,454642,42676,1285600
73,2021-02-25,20389,851451,26541.0,481183,,,,,20389,851451,26541,481183,46930,1332530
74,2021-02-26,26715,878166,26192.0,507375,,,,,26715,878166,26192,507375,52907,1385437
75,2021-02-27,15994,894160,11150.0,518525,,,,,15994,894160,11150,518525,27144,1412581
76,2021-02-28,15496,909656,4871.0,523396,,,,,15496,909656,4871,523396,20367,1432948
77,2021-03-01,26844,936500,12562.0,535958,,,,,26844,936500,12562,535958,39406,1472354
78,2021-03-02,23906,960406,13260.0,549218,,,32.0,32.0,23938,960438,13292,549250,37198,1509552
79,2021-03-03,30179,990585,18381.0,567599,,,186.0,218.0,30365,990803,18567,567817,48746,1558298
80,2021-03-04,30947,1021532,18178.0,585777,,,4067.0,4285.0,35014,1025817,22245,590062,53192,1611490
81,2021-03-05,30005,1051537,19704.0,605481,,,4910.0,9195.0,34915,1060732,24614,614676,54619,1666109
82,2021-03-06,18904,1070441,9501.0,614982,,,6006.0,15201.0,24910,1085642,15507,630183,34411,1700520
83,2021-03-07,12116,1082557,4848.0,619830,,,6612.0,21813.0,18728,1104370,11460,641643,23576,1724096
84,2021-03-08,25861,1108418,8831.0,628661,,,8277.0,30090.0,34138,1138508,17108,658751,42969,1767065
85,2021-03-09,26110,1134528,15453.0,644114,,,8345.0,38435.0,34455,1172963,23798,682549,49908,1816973
86,2021-03-10,29841,1164369,15981.0,660095,,,7940.0,46375.0,37781,1210744,23921,706470,53762,1870735
87,2021-03-11,35970,1200339,16395.0,676490,,,3981.0,50356.0,39951,1250695,20376,726846,56346,1927081
88,2021-03-12,36902,1237241,18084.0,694574,,,2923.0,53279.0,39825,1290520,21007,747853,57909,1984990
89,2021-03-13,22655,1259896,10276.0,704850,,,1626.0,54905.0,24281,1314801,11902,759755,34557,2019547
90,2021-03-14,17833,1277729,6712.0,711562,,,1004.0,55909.0,18837,1333638,7716,767471,25549,2045096
91,2021-03-15,29807,1307536,11285.0,722847,,,596.0,56505.0,30403,1364041,11881,779352,41688,2086784
92,2021-03-16,33410,1340946,13561.0,736408,,,769.0,57274.0,34179,1398220,14330,793682,47740,2134524
93,2021-03-17,37556,1378502,17032.0,753440,,,1180.0,58454.0,38736,1436956,18212,811894,55768,2190292
94,2021-03-18,41430,1419932,12623.0,766063,,,1348.0,59802.0,42778,1479734,13971,825865,55401,2245693
95,2021-03-19,38318,1458250,15413.0,781476,,,1036.0,60838.0,39354,1519088,16449,842314,54767,2300460
96,2021-03-20,24687,1482937,10143.0,791619,,,702.0,61540.0,25389,1544477,10845,853159,35532,2335992
97,2021-03-21,19167,1502104,7866.0,799485,,,336.0,61876.0,19503,1563980,8202,861361,27369,2363361
98,2021-03-22,32576,1534680,11462.0,810947,,,835.0,62711.0,33411,1597391,12297,873658,44873,2408234
99,2021-03-23,38414,1573094,17785.0,828732,,,1553.0,64264.0,39967,1637358,19338,892996,57752,2465986
100,2021-03-24,41069,1614163,21185.0,849917,,,1384.0,65648.0,42453,1679811,22569,915565,63638,2529624
101,2021-03-25,42864,1657027,21673.0,871590,,,2458.0,68106.0,45322,1725133,24131,939696,66995,2596619
102,2021-03-26,36330,1693357,26660.0,898250,,,2496.0,70602.0,38826,1763959,29156,968852,65486,2662105
103,2021-03-27,26459,1719816,17272.0,915522,,,2491.0,73093.0,28950,1792909,19763,988615,46222,2708327
104,2021-03-28,17005,1736821,12632.0,928154,,,1616.0,74709.0,18621,1811530,14248,1002863,31253,2739580
105,2021-03-29,29710,1766531,26266.0,954420,,,1140.0,75849.0,30850,1842380,27406,1030269,57116,2796696
106,2021-03-30,40041,1806572,28974.0,983394,,,1860.0,77709.0,41901,1884281,30834,1061103,70875,2867571
107,2021-03-31,41026,1847598,34668.0,1018062,,,5746.0,83455.0,46772,1931053,40414,1101517,81440,2949011
108,2021-04-01,42238,1889836,40936.0,1058998,,,5722.0,89177.0,47960,1979013,46658,1148175,88896,3037907
109,2021-04-02,34900,1924736,32650.0,1091648,,,6121.0,95298.0,41021,2020034,38771,1186946,73671,3111578
110,2021-04-03,21125,1945861,19176.0,1110824,,,4367.0,99665.0,25492,2045526,23543,1210489,44668,3156246
111,2021-04-04,8264,1954125,10182.0,1121006,,,965.0,100630.0,9229,2054755,11147,1221636,19411,3175657
112,2021-04-05,27928,1982053,28887.0,1149893,,,6653.0,107283.0,34581,2089336,35540,1257176,63468,3239125
113,2021-04-06,39753,2021806,30421.0,1180314,,,10488.0,117771.0,50241,2139577,40909,1298085,80662,3319787
114,2021-04-07,36058,2057864,34246.0,1214560,,,12980.0,130751.0,49038,2188615,47226,1345311,83284,3403071
115,2021-04-08,42276,2100140,36068.0,1250628,,,13861.0,144612.0,56137,2244752,49929,1395240,92205,3495276
116,2021-04-09,34039,2134179,36304.0,1286932,,,14522.0,159134.0,48561,2293313,50826,1446066,84865,3580141
117,2021-04-10,23453,2157632,23117.0,1310049,,,7633.0,166767.0,31086,2324399,30750,1476816,54203,3634344
118,2021-04-11,17558,2175190,13272.0,1323321,,,10122.0,176889.0,27680,2352079,23394,1500210,40952,3675296
119,2021-04-12,24591,2199781,33141.0,1356462,,,10897.0,187786.0,35488,2387567,44038,1544248,68629,3743925
120,2021-04-13,126173,2325954,91214.0,1447676,,,3292.0,191078.0,129465,2517032,94506,1638754,220679,3964604
121,2021-04-14,40698,2366652,37780.0,1485456,,,211.0,191289.0,40909,2557941,37991,1676745,78689,4043293
122,2021-04-15,41406,2408058,39501.0,1524957,,,173.0,191462.0,41579,2599520,39674,1716419,81080,4124373
123,2021-04-16,37146,2445204,38816.0,1563773,,,23.0,191485.0,37169,2636689,38839,1755258,75985,4200358
124,2021-04-17,32790,2477994,22015.0,1585788,,,12.0,191497.0,32802,2669491,22027,1777285,54817,4255175
125,2021-04-18,20063,2498057,16187.0,1601975,,,5.0,191502.0,20068,2689559,16192,1793477,36255,4291430
126,2021-04-19,29865,2527922,36532.0,1638507,,,61.0,191563.0,29926,2719485,36593,1830070,66458,4357888
127,2021-04-20,32915,2560837,44414.0,1682921,,,57.0,191620.0,32972,2752457,44471,1874541,77386,4435274
128,2021-04-21,39801,2600638,47020.0,1729941,,,25.0,191645.0,39826,2792283,47045,1921586,86846,4522120
129,2021-04-22,35809,2636447,42631.0,1772572,,,16.0,191661.0,35825,2828108,42647,1964233,78456,4600576
130,2021-04-23,33123,2669570,40108.0,1812680,,,14.0,191675.0,33137,2861245,40122,2004355,73245,4673821
131,2021-04-24,26391,2695961,27867.0,1840547,,,81.0,191756.0,26472,2887717,27948,2032303,54339,4728160
132,2021-04-25,20224,2716185,10957.0,1851504,,,31.0,191787.0,20255,2907972,10988,2043291,31212,4759372
133,2021-04-26,27399,2743584,32685.0,1884189,,,202.0,191989.0,27601,2935573,32887,2076178,60286,4819658
134,2021-04-27,26694,2770278,33044.0,1917233,,,1098.0,193087.0,27792,2963365,34142,2110320,60836,4880494
135,2021-04-28,28925,2799203,39495.0,1956728,,,1362.0,194449.0,30287,2993652,40857,2151177,69782,4950276
136,2021-04-29,27076,2826279,39683.0,1996411,,,1463.0,195912.0,28539,3022191,41146,2192323,68222,5018498
137,2021-04-30,28197,2854476,32241.0,2028652,,,1646.0,197558.0,29843,3052034,33887,2226210,62084,5080582
138,2021-05-01,20607,2875083,26614.0,2055266,,,1045.0,198603.0,21652,3073686,27659,2253869,48266,5128848
139,2021-05-02,10281,2885364,17031.0,2072297,,,822.0,199425.0,11103,3084789,17853,2271722,28134,5156982
140,2021-05-03,12747,2898111,28559.0,2100856,,,1915.0,201340.0,14662,3099451,30474,2302196,43221,5200203
141,2021-05-04,13568,2911679,38566.0,2139422,,,1737.0,203077.0,15305,3114756,40303,2342499,53871,5254074
142,2021-05-05,19321,2931000,37721.0,2177143,,,1921.0,204998.0,21242,3135998,39642,2382141,58963,5313037
143,2021-05-06,16917,2947917,40568.0,2217711,,,1720.0,206718.0,18637,3154635,42288,2424429,59205,5372242
144,2021-05-07,17581,2965498,36984.0,2254695,,,1958.0,208676.0,19539,3174174,38942,2463371,56523,5428765
145,2021-05-08,10783,2976281,31213.0,2285908,,,1291.0,209967.0,12074,3186248,32504,2495875,43287,5472052
146,2021-05-09,5079,2981360,12231.0,2298139,,,695.0,210662.0,5774,3192022,12926,2508801,18005,5490057
147,2021-05-10,8955,2990315,31034.0,2329173,,,1362.0,212024.0,10317,3202339,32396,2541197,41351,5531408
148,2021-05-11,12182,3002497,30260.0,2359433,,,1440.0,213464.0,13622,3215961,31700,2572897,43882,5575290
149,2021-05-12,13945,3016442,38562.0,2397995,,,1919.0,215383.0,15864,3231825,40481,2613378,54426,5629716
150,2021-05-13,21857,3038299,33434.0,2431429,,,1345.0,216728.0,23202,3255027,34779,2648157,56636,5686352
151,2021-05-14,24369,3062668,30012.0,2461441,,,1775.0,218503.0,26144,3281171,31787,2679944,56156,5742508
152,2021-05-15,21916,3084584,25089.0,2486530,,,1490.0,219993.0,23406,3304577,26579,2706523,48495,5791003
153,2021-05-16,9082,3093666,17572.0,2504102,,,1113.0,221106.0,10195,3314772,18685,2725208,27767,5818770
154,2021-05-17,16843,3110509,28365.0,2532467,,,1949.0,223055.0,18792,3333564,30314,2755522,47157,5865927
155,2021-05-18,21243,3131752,30667.0,2563134,,,1942.0,224997.0,23185,3356749,32609,2788131,53852,5919779
156,2021-05-19,27629,3159381,32396.0,2595530,,,1628.0,226625.0,29257,3386006,34024,2822155,61653,5981432
157,2021-05-20,20802,3180183,33232.0,2628762,,,1966.0,228591.0,22768,3408774,35198,2857353,56000,6037432
158,2021-05-21,19157,3199340,30312.0,2659074,,,1607.0,230198.0,20764,3429538,31919,2889272,51076,6088508
159,2021-05-22,16922,3216262,20660.0,2679734,,,1270.0,231468.0,18192,3447730,21930,2911202,38852,6127360
160,2021-05-23,8757,3225019,11433.0,2691167,,,964.0,232432.0,9721,3457451,12397,2923599,21154,6148514
161,2021-05-24,13560,3238579,17751.0,2708918,,,1473.0,233905.0,15033,3472484,19224,2942823,32784,6181298
162,2021-05-25,13059,3251638,18704.0,2727622,,,1329.0,235234.0,14388,3486872,20033,2962856,33092,6214390
163,2021-05-26,18298,3269936,19482.0,2747104,,,1511.0,236745.0,19809,3506681,20993,2983849,39291,6253681
164,2021-05-27,11683,3281619,18637.0,2765741,,,1116.0,237861.0,12799,3519480,19753,3003602,31436,6285117
165,2021-05-28,12404,3294023,19815.0,2785556,,,1399.0,239260.0,13803,3533283,21214,3024816,33618,6318735
166,2021-05-29,9549,3303572,11658.0,2797214,,,935.0,240195.0,10484,3543767,12593,3037409,22142,6340877
167,2021-05-30,4965,3308537,6421.0,2803635,,,595.0,240790.0,5560,3549327,7016,3044425,11981,6352858
168,2021-05-31,1776,3310313,3711.0,2807346,,,305.0,241095.0,2081,3551408,4016,3048441,5792,6358650
169,2021-06-01,9824,3320137,16403.0,2823749,,,1157.0,242252.0,10981,3562389,17560,3066001,27384,6386034
170,2021-06-02,10229,3330366,16795.0,2840544,,,959.0,243211.0,11188,3573577,17754,3083755,27983,6414017
171,2021-06-03,7896,3338262,21165.0,2861709,,,1086.0,244297.0,8982,3582559,22251,3106006,30147,6444164
172,2021-06-04,8166,3346428,22321.0,2884030,,,1120.0,245417.0,9286,3591845,23441,3129447,31607,6475771
173,2021-06-05,7000,3353428,19430.0,2903460,,,720.0,246137.0,7720,3599565,20150,3149597,27150,6502921
174,2021-06-06,3458,3356886,7233.0,2910693,,,423.0,246560.0,3881,3603446,7656,3157253,11114,6514035
175,2021-06-07,6851,3363737,15747.0,2926440,,,726.0,247286.0,7577,3611023,16473,3173726,23324,6537359
176,2021-06-08,6665,3370402,19683.0,2946123,,,829.0,248115.0,7494,3618517,20512,3194238,27177,6564536
177,2021-06-09,8191,3378593,23922.0,2970045,,,970.0,249085.0,9161,3627678,24892,3219130,33083,6597619
178,2021-06-10,7143,3385736,19102.0,2989147,,,894.0,249979.0,8037,3635715,19996,3239126,27139,6624758
179,2021-06-11,7471,3393207,17699.0,3006846,,,1125.0,251104.0,8596,3644311,18824,3257950,26295,6651053
180,2021-06-12,5230,3398437,14742.0,3021588,,,605.0,251709.0,5835,3650146,15347,3273297,20577,6671630
181,2021-06-13,1931,3400368,7563.0,3029151,,,427.0,252136.0,2358,3652504,7990,3281287,9921,6681551
182,2021-06-14,5657,3406025,11801.0,3040952,,,734.0,252870.0,6391,3658895,12535,3293822,18192,6699743
183,2021-06-15,5630,3411655,14323.0,3055275,,,873.0,253743.0,6503,3665398,15196,3309018,20826,6720569
184,2021-06-16,8747,3420402,21566.0,3076841,,,757.0,254500.0,9504,3674902,22323,3331341,31070,6751639
185,2021-06-17,6683,3427085,12351.0,3089192,,,720.0,255220.0,7403,3682305,13071,3344412,19754,6771393
186,2021-06-18,6835,3433920,12721.0,3101913,,,704.0,255924.0,7539,3689844,13425,3357837,20260,6791653
187,2021-06-19,4658,3438578,9359.0,3111272,,,614.0,256538.0,5272,3695116,9973,3367810,14631,6806284
188,2021-06-20,2505,3441083,5048.0,3116320,,,377.0,256915.0,2882,3697998,5425,3373235,7930,6814214
189,2021-06-21,5556,3446639,5332.0,3121652,,,635.0,257550.0,6191,3704189,5967,3379202,11523,6825737
190,2021-06-22,5344,3451983,9036.0,3130688,,,692.0,258242.0,6036,3710225,9728,3388930,15072,6840809
191,2021-06-23,6061,3458044,10312.0,3141000,,,646.0,258888.0,6707,3716932,10958,3399888,17019,6857828
192,2021-06-24,5930,3463974,8188.0,3149188,,,594.0,259482.0,6524,3723456,8782,3408670,14712,6872540
193,2021-06-25,5804,3469778,8644.0,3157832,,,620.0,260102.0,6424,3729880,9264,3417934,15068,6887608
194,2021-06-26,3700,3473478,6296.0,3164128,,,396.0,260498.0,4096,3733976,6692,3424626,10392,6898000
195,2021-06-27,2809,3476287,3516.0,3167644,,,185.0,260683.0,2994,3736970,3701,3428327,6510,6904510
196,2021-06-28,4914,3481201,6372.0,3174016,,,539.0,261222.0,5453,3742423,6911,3435238,11825,6916335
197,2021-06-29,5059,3486260,6460.0,3180476,,,520.0,261742.0,5579,3748002,6980,3442218,12039,6928374
198,2021-06-30,5617,3491877,7375.0,3187851,,,605.0,262347.0,6222,3754224,7980,3450198,13597,6941971
199,2021-07-01,5396,3497273,6960.0,3194811,,,498.0,262845.0,5894,3760118,7458,3457656,12854,6954825
200,2021-07-02,5284,3502557,6824.0,3201635,,,523.0,263368.0,5807,3765925,7347,3465003,12631,6967456
201,2021-07-03,3265,3505822,4059.0,3205694,,,264.0,263632.0,3529,3769454,4323,3469326,7588,6975044
202,2021-07-04,492,3506314,544.0,3206238,,,67.0,263699.0,559,3770013,611,3469937,1103,6976147
203,2021-07-05,3760,3510074,3949.0,3210187,,,287.0,263986.0,4047,3774060,4236,3474173,7996,6984143
204,2021-07-06,4486,3514560,6252.0,3216439,,,452.0,264438.0,4938,3778998,6704,3480877,11190,6995333
205,2021-07-07,4458,3519018,6394.0,3222833,,,482.0,264920.0,4940,3783938,6876,3487753,11334,7006667
206,2021-07-08,4827,3523845,6147.0,3228980,,,563.0,265483.0,5390,3789328,6710,3494463,11537,7018204
207,2021-07-09,5351,3529196,6644.0,3235624,,,571.0,266054.0,5922,3795250,7215,3501678,12566,7030770
208,2021-07-10,3524,3532720,4383.0,3240007,,,302.0,266356.0,3826,3799076,4685,3506363,8209,7038979
209,2021-07-11,2672,3535392,2564.0,3242571,,,225.0,266581.0,2897,3801973,2789,3509152,5461,7044440
210,2021-07-12,4408,3539800,5104.0,3247675,,,378.0,266959.0,4786,3806759,5482,3514634,9890,7054330
211,2021-07-13,4656,3544456,4706.0,3252381,,,366.0,267325.0,5022,3811781,5072,3519706,9728,7064058
212,2021-07-14,4608,3549064,5262.0,3257643,,,421.0,267746.0,5029,3816810,5683,3525389,10291,7074349
213,2021-07-15,4885,3553949,5000.0,3262643,,,357.0,268103.0,5242,3822052,5357,3530746,10242,7084591
214,2021-07-16,6271,3560220,5824.0,3268467,,,401.0,268504.0,6672,3828724,6225,3536971,12496,7097087
215,2021-07-17,3413,3563633,3544.0,3272011,,,299.0,268803.0,3712,3832436,3843,3540814,7256,7104343
216,2021-07-18,2304,3565937,2371.0,3274382,,,110.0,268913.0,2414,3834850,2481,3543295,4785,7109128
217,2021-07-19,5130,3571067,4603.0,3278985,,,379.0,269292.0,5509,3840359,4982,3548277,10112,7119240
218,2021-07-20,5314,3576381,4703.0,3283688,,,366.0,269658.0,5680,3846039,5069,3553346,10383,7129623
219,2021-07-21,5632,3582013,4921.0,3288609,,,416.0,270074.0,6048,3852087,5337,3558683,10969,7140592
220,2021-07-22,6009,3588022,4616.0,3293225,,,469.0,270543.0,6478,3858565,5085,3563768,11094,7151686
221,2021-07-23,6828,3594850,4825.0,3298050,,,493.0,271036.0,7321,3865886,5318,3569086,12146,7163832
222,2021-07-24,4278,3599128,3195.0,3301245,,,267.0,271303.0,4545,3870431,3462,3572548,7740,7171572
223,2021-07-25,3290,3602418,1111.0,3302356,,,138.0,271441.0,3428,3873859,1249,3573797,4539,7176111
224,2021-07-26,6197,3608615,3890.0,3306246,,,418.0,271859.0,6615,3880474,4308,3578105,10505,7186616
225,2021-07-27,6582,3615197,4264.0,3310510,,,457.0,272316.0,7039,3887513,4721,3582826,11303,7197919
226,2021-07-28,7063,3622260,4127.0,3314637,,,460.0,272776.0,7523,3895036,4587,3587413,11650,7209569
227,2021-07-29,7058,3629318,4288.0,3318925,,,419.0,273195.0,7477,3902513,4707,3592120,11765,7221334
228,2021-07-30,7797,3637115,4784.0,3323709,,,525.0,273720.0,8322,3910835,5309,3597429,13106,7234440
229,2021-07-31,4791,3641906,3054.0,3326763,,,273.0,273993.0,5064,3915899,3327,3600756,8118,7242558
230,2021-08-01,3869,3645775,2151.0,3328914,139.0,139.0,161.0,274154.0,4030,3919929,2312,3603068,6320,7248878
231,2021-08-02,7228,3653003,3824.0,3332738,123.0,262.0,339.0,274493.0,7567,3927496,4163,3607231,11514,7260392
232,2021-08-03,7231,3660234,4073.0,3336811,85.0,347.0,515.0,275008.0,7746,3935242,4588,3611819,11904,7272296
233,2021-08-04,7400,3667634,4086.0,3340897,96.0,443.0,532.0,275540.0,7932,3943174,4618,3616437,12114,7284410
234,2021-08-05,7930,3675564,4269.0,3345166,95.0,538.0,537.0,276077.0,8467,3951641,4806,3621243,12831,7297241
235,2021-08-06,8292,3683856,4705.0,3349871,121.0,659.0,453.0,276530.0,8745,3960386,5158,3626401,13571,7310812
236,2021-08-07,5267,3689123,2807.0,3352678,88.0,747.0,263.0,276793.0,5530,3965916,3070,3629471,8425,7319237
237,2021-08-08,3951,3693074,2047.0,3354725,62.0,809.0,143.0,276936.0,4094,3970010,2190,3631661,6203,7325440
238,2021-08-09,6920,3699994,4517.0,3359242,91.0,900.0,368.0,277304.0,7288,3977298,4885,3636546,11896,7337336
239,2021-08-10,7130,3707124,4446.0,3363688,103.0,1003.0,338.0,277642.0,7468,3984766,4784,3641330,12017,7349353
240,2021-08-11,7050,3714174,4422.0,3368110,100.0,1103.0,441.0,278083.0,7491,3992257,4863,3646193,12013,7361366
241,2021-08-12,8598,3722772,4719.0,3372829,139.0,1242.0,444.0,278527.0,9042,4001299,5163,3651356,13900,7375266
242,2021-08-13,7136,3729908,5357.0,3378186,189.0,1431.0,396.0,278923.0,7532,4008831,5753,3657109,13078,7388344
243,2021-08-14,4911,3734819,3337.0,3381523,672.0,2103.0,285.0,279208.0,5196,4014027,3622,3660731,9205,7397549
244,2021-08-15,3324,3738143,2729.0,3384252,567.0,2670.0,163.0,279371.0,3487,4017514,2892,3663623,6783,7404332
245,2021-08-16,5428,3743571,5082.0,3389334,1238.0,3908.0,352.0,279723.0,5780,4023294,5434,3669057,12100,7416432
246,2021-08-17,6808,3750379,5345.0,3394679,1433.0,5341.0,389.0,280112.0,7197,4030491,5734,3674791,13975,7430407
247,2021-08-18,6320,3756699,5480.0,3400159,1612.0,6953.0,478.0,280590.0,6798,4037289,5958,3680749,13890,7444297
248,2021-08-19,6205,3762904,5537.0,3405696,1624.0,8577.0,416.0,281006.0,6621,4043910,5953,3686702,13782,7458079
249,2021-08-20,6831,3769735,6530.0,3412226,1704.0,10281.0,401.0,281407.0,7232,4051142,6931,3693633,15466,7473545
250,2021-08-21,4320,3774055,3913.0,3416139,865.0,11146.0,228.0,281635.0,4548,4055690,4141,3697774,9326,7482871
251,2021-08-22,3057,3777112,3167.0,3419306,798.0,11944.0,110.0,281745.0,3167,4058857,3277,3701051,7132,7490003
252,2021-08-23,5984,3783096,6080.0,3425386,1783.0,13727.0,285.0,282030.0,6269,4065126,6365,3707416,14132,7504135
253,2021-08-24,6547,3789643,6042.0,3431428,1726.0,15453.0,423.0,282453.0,6970,4072096,6465,3713881,14738,7518873
254,2021-08-25,6713,3796356,6199.0,3437627,1578.0,17031.0,440.0,282893.0,7153,4079249,6639,3720520,14930,7533803
255,2021-08-26,6964,3803320,6639.0,3444266,1713.0,18744.0,427.0,283320.0,7391,4086640,7066,3727586,15743,7549546
256,2021-08-27,6823,3810143,7055.0,3451321,1997.0,20741.0,316.0,283636.0,7139,4093779,7371,3734957,16191,7565737
257,2021-08-28,6898,3817041,6501.0,3457822,995.0,21736.0,324.0,283960.0,7222,4101001,6825,3741782,14718,7580455
258,2021-08-29,3732,3820773,3680.0,3461502,671.0,22407.0,610.0,284570.0,4342,4105343,4290,3746072,8693,7589148
259,2021-08-30,5927,3826700,6110.0,3467612,1524.0,23931.0,959.0,285529.0,6886,4112229,7069,3753141,14520,7603668
260,2021-08-31,5891,3832591,6037.0,3473649,1643.0,25574.0,946.0,286475.0,6837,4119066,6983,3760124,14517,7618185
261,2021-09-01,5573,3838164,5630.0,3479279,1676.0,27250.0,914.0,287389.0,6487,4125553,6544,3766668,13793,7631978
262,2021-09-02,5518,3843682,5907.0,3485186,1841.0,29091.0,703.0,288092.0,6221,4131774,6610,3773278,13969,7645947
263,2021-09-03,5987,3849669,6898.0,3492084,1813.0,30904.0,973.0,289065.0,6960,4138734,7871,3781149,15671,7661618
264,2021-09-04,3717,3853386,4335.0,3496419,863.0,31767.0,879.0,289944.0,4596,4143330,5214,3786363,9794,7671412
265,2021-09-05,2952,3856338,2807.0,3499226,650.0,32417.0,106.0,290050.0,3058,4146388,2913,3789276,6515,7677927
266,2021-09-06,1059,3857397,1149.0,3500375,208.0,32625.0,63.0,290113.0,1122,4147510,1212,3790488,2479,7680406
267,2021-09-07,5333,3862730,7274.0,3507649,1403.0,34028.0,2304.0,292417.0,7637,4155147,9578,3800066,16314,7696720
268,2021-09-08,4645,3867375,5462.0,3513111,1552.0,35580.0,364.0,292781.0,5009,4160156,5826,3805892,12023,7708743
269,2021-09-09,5001,3872376,5436.0,3518547,2258.0,37838.0,324.0,293105.0,5325,4165481,5760,3811652,13019,7721762
270,2021-09-10,6507,3878883,6639.0,3525186,2449.0,40287.0,1718.0,294823.0,8225,4173706,8357,3820009,17313,7739075
271,2021-09-11,4169,3883052,4324.0,3529510,1003.0,41290.0,665.0,295488.0,4834,4178540,4989,3824998,10161,7749236
272,2021-09-12,3162,3886214,3236.0,3532746,690.0,41980.0,436.0,295924.0,3598,4182138,3672,3828670,7524,7756760
273,2021-09-13,4877,3891091,5042.0,3537788,1519.0,43499.0,346.0,296270.0,5223,4187361,5388,3834058,11784,7768544
274,2021-09-14,4760,3895851,5422.0,3543210,1586.0,45085.0,435.0,296705.0,5195,4192556,5857,3839915,12203,7780747
275,2021-09-15,5024,3900875,5854.0,3549064,1460.0,46545.0,388.0,297093.0,5412,4197968,6242,3846157,12726,7793473
276,2021-09-16,4798,3905673,5821.0,3554885,1596.0,48141.0,336.0,297429.0,5134,4203102,6157,3852314,12551,7806024
277,2021-09-17,5242,3910915,6571.0,3561456,1906.0,50047.0,343.0,297772.0,5585,4208687,6914,3859228,14062,7820086
278,2021-09-18,3791,3914706,4563.0,3566019,919.0,50966.0,185.0,297957.0,3976,4212663,4748,3863976,9458,7829544
279,2021-09-19,2742,3917448,3158.0,3569177,686.0,51652.0,75.0,298032.0,2817,4215480,3233,3867209,6661,7836205
280,2021-09-20,3747,3921195,4670.0,3573847,1722.0,53374.0,430.0,298462.0,4177,4219657,5100,3872309,10569,7846774
281,2021-09-21,3999,3925194,4991.0,3578838,1836.0,55210.0,326.0,298788.0,4325,4223982,5317,3877626,11152,7857926
282,2021-09-22,4189,3929383,4760.0,3583598,1726.0,56936.0,458.0,299246.0,4647,4228629,5218,3882844,11133,7869059
283,2021-09-23,4162,3933545,4721.0,3588319,2163.0,59099.0,492.0,299738.0,4654,4233283,5213,3888057,11538,7880597
284,2021-09-24,5067,3938612,5597.0,3593916,4809.0,63908.0,422.0,300160.0,5489,4238772,6019,3894076,15895,7896492
285,2021-09-25,3626,3942238,3623.0,3597539,4901.0,68809.0,385.0,300545.0,4011,4242783,4008,3898084,12535,7909027
286,2021-09-26,2358,3944596,2658.0,3600197,3050.0,71859.0,424.0,300969.0,2782,4245565,3082,3901166,8490,7917517
287,2021-09-27,4501,3949097,2695.0,3602892,8833.0,80692.0,509.0,301478.0,5010,4250575,3204,3904370,16538,7934055
288,2021-09-28,4394,3953491,4440.0,3607332,9410.0,90102.0,211.0,301689.0,4605,4255180,4651,3909021,18455,7952510
289,2021-09-29,4696,3958187,4503.0,3611835,9792.0,99894.0,919.0,302608.0,5615,4260795,5422,3914443,19910,7972420
290,2021-09-30,4880,3963067,4552.0,3616387,9916.0,109810.0,792.0,303400.0,5672,4266467,5344,3919787,20140,7992560
291,2021-10-01,5474,3968541,5309.0,3621696,11774.0,121584.0,782.0,304182.0,6256,4272723,6091,3925878,23339,8015899
292,2021-10-02,2937,3971478,2888.0,3624584,5748.0,127332.0,187.0,304369.0,3124,4275847,3075,3928953,11760,8027659
293,2021-10-03,2078,3973556,2372.0,3626956,3447.0,130779.0,86.0,304455.0,2164,4278011,2458,3931411,7983,8035642
294,2021-10-04,4019,3977575,3495.0,3630451,9792.0,140571.0,232.0,304687.0,4251,4282262,3727,3935138,17538,8053180
295,2021-10-05,3952,3981527,3658.0,3634109,10125.0,150696.0,207.0,304894.0,4159,4286421,3865,3939003,17942,8071122
296,2021-10-06,4024,3985551,3574.0,3637683,8906.0,159602.0,264.0,305158.0,4288,4290709,3838,3942841,16768,8087890
297,2021-10-07,4229,3989780,3623.0,3641306,9906.0,169508.0,331.0,305489.0,4560,4295269,3954,3946795,18089,8105979
298,2021-10-08,4777,3994557,4275.0,3645581,11344.0,180852.0,282.0,305771.0,5059,4300328,4557,3951352,20678,8126657
299,2021-10-09,2683,3997240,2673.0,3648254,4292.0,185144.0,270.0,306041.0,2953,4303281,2943,3954295,9918,8136575
300,2021-10-10,1865,3999105,1843.0,3650097,2941.0,188085.0,59.0,306100.0,1924,4305205,1902,3956197,6708,8143283
301,2021-10-11,4217,4003322,3330.0,3653427,9193.0,197278.0,249.0,306349.0,4466,4309671,3579,3959776,16989,8160272
302,2021-10-12,3591,4006913,3525.0,3656952,9534.0,206812.0,271.0,306620.0,3862,4313533,3796,3963572,16921,8177193
303,2021-10-13,3956,4010869,3445.0,3660397,8718.0,215530.0,346.0,306966.0,4302,4317835,3791,3967363,16465,8193658
304,2021-10-14,5161,4016030,5482.0,3665879,9373.0,224903.0,429.0,307395.0,5590,4323425,5911,3973274,20445,8214103
305,2021-10-15,4704,4020734,4584.0,3670463,10581.0,235484.0,347.0,307742.0,5051,4328476,4931,3978205,20216,8234319
306,2021-10-16,2494,4023228,2500.0,3672963,4511.0,239995.0,290.0,308032.0,2784,4331260,2790,3980995,9795,8244114
307,2021-10-17,1808,4025036,1775.0,3674738,2770.0,242765.0,55.0,308087.0,1863,4333123,1830,3982825,6408,8250522
308,2021-10-18,4287,4029323,3568.0,3678306,9194.0,251959.0,266.0,308353.0,4553,4337676,3834,3986659,17315,8267837
309,2021-10-19,4301,4033624,4023.0,3682329,9524.0,261483.0,222.0,308575.0,4523,4342199,4245,3990904,18070,8285907
310,2021-10-20,3529,4037153,3417.0,3685746,8946.0,270429.0,254.0,308829.0,3783,4345982,3671,3994575,16146,8302053
311,2021-10-21,3300,4040453,3255.0,3689001,9891.0,280320.0,290.0,309119.0,3590,4349572,3545,3998120,16736,8318789
312,2021-10-22,4685,4045138,4024.0,3693025,18559.0,298879.0,475.0,309594.0,5160,4354732,4499,4002619,27743,8346532
313,2021-10-23,2891,4048029,2112.0,3695137,10867.0,309746.0,321.0,309915.0,3212,4357944,2433,4005052,16191,8362723
314,2021-10-24,2060,4050089,1558.0,3696695,7154.0,316900.0,78.0,309993.0,2138,4360082,1636,4006688,10850,8373573
315,2021-10-25,4548,4054637,3074.0,3699769,23216.0,340116.0,316.0,310309.0,4864,4364946,3390,4010078,31154,8404727
316,2021-10-26,4511,4059148,3087.0,3702856,25418.0,365534.0,311.0,310620.0,4822,4369768,3398,4013476,33327,8438054
317,2021-10-27,4737,4063885,3343.0,3706199,25507.0,391041.0,429.0,311049.0,5166,4374934,3772,4017248,34016,8472070
318,2021-10-28,4556,4068441,3364.0,3709563,26203.0,417244.0,496.0,311545.0,5052,4379986,3860,4021108,34619,8506689
319,2021-10-29,4970,4073411,3911.0,3713474,26318.0,443562.0,393.0,311938.0,5363,4385349,4304,4025412,35592,8542281
320,2021-10-30,2633,4076044,1841.0,3715315,13486.0,457048.0,308.0,312246.0,2941,4388290,2149,4027561,18268,8560549
321,2021-10-31,1944,4077988,1516.0,3716831,7785.0,464833.0,93.0,312339.0,2037,4390327,1609,4029170,11338,8571887
322,2021-11-01,4688,4082676,3420.0,3720251,25484.0,490317.0,342.0,312681.0,5030,4395357,3762,4032932,33934,8605821
323,2021-11-02,4250,4086926,2944.0,3723195,25869.0,516186.0,406.0,313087.0,4656,4400013,3350,4036282,33469,8639290
324,2021-11-03,4668,4091594,3056.0,3726251,25940.0,542126.0,458.0,313545.0,5126,4405139,3514,4039796,34122,8673412
325,2021-11-04,6289,4097883,3358.0,3729609,26788.0,568914.0,512.0,314057.0,6801,4411940,3870,4043666,36947,8710359
326,2021-11-05,8215,4106098,3758.0,3733367,28000.0,596914.0,408.0,314465.0,8623,4420563,4166,4047832,40381,8750740
327,2021-11-06,10070,4116168,1974.0,3735341,12777.0,609691.0,305.0,314770.0,10375,4430938,2279,4050111,25126,8775866
328,2021-11-07,7717,4123885,1468.0,3736809,7338.0,617029.0,94.0,314864.0,7811,4438749,1562,4051673,16617,8792483
329,2021-11-08,11286,4135171,3039.0,3739848,19481.0,636510.0,379.0,315243.0,11665,4450414,3418,4055091,34185,8826668
330,2021-11-09,11749,4146920,2656.0,3742504,23036.0,659546.0,268.0,315511.0,12017,4462431,2924,4058015,37709,8864377
331,2021-11-10,12562,4159482,2763.0,3745267,23615.0,683161.0,337.0,315848.0,12899,4475330,3100,4061115,39277,8903654
332,2021-11-11,11326,4170808,2382.0,3747649,22034.0,705195.0,282.0,316130.0,11608,4486938,2664,4063779,36024,8939678
333,2021-11-12,12270,4183078,3353.0,3751002,25946.0,731141.0,548.0,316678.0,12818,4499756,3901,4067680,42117,8981795
334,2021-11-13,9770,4192848,1587.0,3752589,12157.0,743298.0,342.0,317020.0,10112,4509868,1929,4069609,23856,9005651
335,2021-11-14,3919,4196767,1129.0,3753718,7223.0,750521.0,121.0,317141.0,4040,4513908,1250,4070859,12392,9018043
336,2021-11-15,8593,4205360,2521.0,3756239,20793.0,771314.0,205.0,317346.0,8798,4522706,2726,4073585,32112,9050155
337,2021-11-16,9211,4214571,2491.0,3758730,23160.0,794474.0,255.0,317601.0,9466,4532172,2746,4076331,35117,9085272
338,2021-11-17,9377,4223948,2875.0,3761605,22758.0,817232.0,312.0,317913.0,9689,4541861,3187,4079518,35322,9120594
339,2021-11-18,9280,4233228,2629.0,3764234,22520.0,839752.0,479.0,318392.0,9759,4551620,3108,4082626,34908,9155502
340,2021-11-19,9779,4243007,2914.0,3767148,27671.0,867423.0,382.0,318774.0,10161,4561781,3296,4085922,40746,9196248
341,2021-11-20,10623,4253630,1606.0,3768754,14239.0,881662.0,454.0,319228.0,11077,4572858,2060,4087982,26922,9223170
342,2021-11-21,4345,4257975,1199.0,3769953,9892.0,891554.0,99.0,319327.0,4444,4577302,1298,4089280,15535,9238705
343,2021-11-22,9777,4267752,2488.0,3772441,24885.0,916439.0,292.0,319619.0,10069,4587371,2780,4092060,37442,9276147
344,2021-11-23,9163,4276915,2398.0,3774839,25028.0,941467.0,280.0,319899.0,9443,4596814,2678,4094738,36869,9313016
345,2021-11-24,8089,4285004,2440.0,3777279,20295.0,961762.0,215.0,320114.0,8304,4605118,2655,4097393,31039,9344055
346,2021-11-25,239,4285243,74.0,3777353,602.0,962364.0,10.0,320124.0,249,4605367,84,4097477,925,9344980
347,2021-11-26,5664,4290907,4011.0,3781364,15968.0,978332.0,152.0,320276.0,5816,4611183,4163,4101640,25795,9370775
348,2021-11-27,3786,4294693,5440.0,3786804,11220.0,989552.0,134.0,320410.0,3920,4615103,5574,4107214,20580,9391355
349,2021-11-28,2419,4297112,6372.0,3793176,7690.0,997242.0,77.0,320487.0,2496,4617599,6449,4113663,16558,9407913
350,2021-11-29,6360,4303472,9243.0,3802419,18845.0,1016087.0,379.0,320866.0,6739,4624338,9622,4123285,34827,9442740
351,2021-11-30,6227,4309699,9239.0,3811658,23116.0,1039203.0,264.0,321130.0,6491,4630829,9503,4132788,38846,9481586
352,2021-12-01,7213,4316912,9564.0,3821222,25496.0,1064699.0,304.0,321434.0,7517,4638346,9868,4142656,42577,9524163
353,2021-12-02,6857,4323769,8677.0,3829899,27036.0,1091735.0,450.0,321884.0,7307,4645653,9127,4151783,43020,9567183
354,2021-12-03,7542,4331311,9183.0,3839082,30632.0,1122367.0,249.0,322133.0,7791,4653444,9432,4161215,47606,9614789
355,2021-12-04,5851,4337162,9717.0,3848799,16627.0,1138994.0,457.0,322590.0,6308,4659752,10174,4171389,32652,9647441
356,2021-12-05,3462,4340624,3243.0,3852042,9899.0,1148893.0,77.0,322667.0,3539,4663291,3320,4174709,16681,9664122
357,2021-12-06,6728,4347352,7059.0,3859101,24430.0,1173323.0,277.0,322944.0,7005,4670296,7336,4182045,38494,9702616
358,2021-12-07,6352,4353704,6948.0,3866049,25468.0,1198791.0,247.0,323191.0,6599,4676895,7195,4189240,39015,9741631
359,2021-12-08,6880,4360584,7309.0,3873358,24710.0,1223501.0,314.0,323505.0,7194,4684089,7623,4196863,39213,9780844
360,2021-12-09,6474,4367058,6947.0,3880305,25223.0,1248724.0,397.0,323902.0,6871,4690960,7344,4204207,39041,9819885
361,2021-12-10,7210,4374268,7285.0,3887590,26751.0,1275475.0,228.0,324130.0,7438,4698398,7513,4211720,41474,9861359
362,2021-12-11,4441,4378709,7597.0,3895187,14302.0,1289777.0,333.0,324463.0,4774,4703172,7930,4219650,26673,9888032
363,2021-12-12,3990,4382699,2782.0,3897969,8095.0,1297872.0,60.0,324523.0,4050,4707222,2842,4222492,14927,9902959
364,2021-12-13,5688,4388387,5719.0,3903688,22227.0,1320099.0,242.0,324765.0,5930,4713152,5961,4228453,33876,9936835
365,2021-12-14,6428,4394815,5880.0,3909568,23648.0,1343747.0,214.0,324979.0,6642,4719794,6094,4234547,36170,9973005
366,2021-12-15,7096,4401911,5614.0,3915182,21996.0,1365743.0,248.0,325227.0,7344,4727138,5862,4240409,34954,10007959
367,2021-12-16,7811,4409722,2793.0,3917975,25358.0,1391101.0,422.0,325649.0,8233,4735371,3215,4243624,36384,10044343
368,2021-12-17,7767,4417489,4129.0,3922104,26527.0,1417628.0,192.0,325841.0,7959,4743330,4321,4247945,38615,10082958
369,2021-12-18,5774,4423263,3166.0,3925270,15324.0,1432952.0,297.0,326138.0,6071,4749401,3463,4251408,24561,10107519
370,2021-12-19,3379,4426642,1340.0,3926610,9730.0,1442682.0,35.0,326173.0,3414,4752815,1375,4252783,14484,10122003
371,2021-12-20,8014,4434656,3714.0,3930324,26802.0,1469484.0,164.0,326337.0,8178,4760993,3878,4256661,38694,10160697
372,2021-12-21,8897,4443553,4086.0,3934410,27141.0,1496625.0,167.0,326504.0,9064,4770057,4253,4260914,40291,10200988
373,2021-12-22,8608,4452161,3807.0,3938217,27475.0,1524100.0,172.0,326676.0,8780,4778837,3979,4264893,40062,10241050
374,2021-12-23,8299,4460460,3486.0,3941703,22965.0,1547065.0,355.0,327031.0,8654,4787491,3841,4268734,35105,10276155
375,2021-12-24,1603,4462063,1000.0,3942703,4691.0,1551756.0,39.0,327070.0,1642,4789133,1039,4269773,7333,10283488
376,2021-12-25,50,4462113,36.0,3942739,291.0,1552047.0,1.0,327071.0,51,4789184,37,4269810,378,10283866
377,2021-12-26,2518,4464631,1741.0,3944480,7046.0,1559093.0,44.0,327115.0,2562,4791746,1785,4271595,11349,10295215
378,2021-12-27,7132,4471763,3943.0,3948423,20667.0,1579760.0,295.0,327410.0,7427,4799173,4238,4275833,32037,10327252
379,2021-12-28,7761,4479524,3743.0,3952166,23689.0,1603449.0,166.0,327576.0,7927,4807100,3909,4279742,35359,10362611
380,2021-12-29,8118,4487642,3953.0,3956119,22438.0,1625887.0,154.0,327730.0,8272,4815372,4107,4283849,34663,10397274
381,2021-12-30,7382,4495024,3734.0,3959853,20842.0,1646729.0,288.0,328018.0,7670,4823042,4022,4287871,32246,10429520
382,2021-12-31,2541,4497565,1510.0,3961363,7171.0,1653900.0,92.0,328110.0,2633,4825675,1602,4289473,11314,10440834
383,2022-01-01,695,4498260,330.0,3961693,1668.0,1655568.0,31.0,328141.0,726,4826401,361,4289834,2724,10443558
384,2022-01-02,2152,4500412,1613.0,3963306,5335.0,1660903.0,42.0,328183.0,2194,4828595,1655,4291489,9142,10452700
385,2022-01-03,3341,4503753,2040.0,3965346,10355.0,1671258.0,220.0,328403.0,3561,4832156,2260,4293749,15956,10468656
386,2022-01-04,5712,4509465,3384.0,3968730,15581.0,1686839.0,162.0,328565.0,5874,4838030,3546,4297295,24839,10493495
387,2022-01-05,6676,4516141,4606.0,3973336,17527.0,1704366.0,173.0,328738.0,6849,4844879,4779,4302074,28982,10522477
388,2022-01-06,6568,4522709,4699.0,3978035,21261.0,1725627.0,258.0,328996.0,6826,4851705,4957,4307031,32786,10555263
389,2022-01-07,5771,4528480,3651.0,3981686,18709.0,1744336.0,158.0,329154.0,5929,4857634,3809,4310840,28289,10583552
390,2022-01-08,4431,4532911,3758.0,3985444,12609.0,1756945.0,73.0,329227.0,4504,4862138,3831,4314671,20871,10604423
391,2022-01-09,2710,4535621,1995.0,3987439,7274.0,1764219.0,154.0,329381.0,2864,4865002,2149,4316820,12133,10616556
392,2022-01-10,6188,4541809,3749.0,3991188,18155.0,1782374.0,153.0,329534.0,6341,4871343,3902,4320722,28245,10644801
393,2022-01-11,6314,4548123,4150.0,3995338,17244.0,1799618.0,137.0,329671.0,6451,4877794,4287,4325009,27845,10672646
394,2022-01-12,6491,4554614,4265.0,3999603,17639.0,1817257.0,220.0,329891.0,6711,4884505,4485,4329494,28615,10701261
395,2022-01-13,6041,4560655,4034.0,4003637,16030.0,1833287.0,129.0,330020.0,6170,4890675,4163,4333657,26234,10727495
396,2022-01-14,6320,4566975,2783.0,4006420,18930.0,1852217.0,229.0,330249.0,6549,4897224,3012,4336669,28262,10755757
397,2022-01-15,2087,4569062,1007.0,4007427,5169.0,1857386.0,41.0,330290.0,2128,4899352,1048,4337717,8304,10764061
